AREA_NAME,YEAR,GENDER,VICTIMS_UPTO_10_YRS,VICTIMS_UPTO_10_15_YRS,VICTIMS_UPTO_15_18_YRS,VICTIMS_UPTO_18_30_YRS,VICTIMS_UPTO_30_50_YRS,VICTIMS_ABOVE_50_YRS,VICTIMS_TOTAL
ANDAMAN & NICOBAR ISLANDS,2001, FEMALE VICTIMS,0,0,0,4,2,0,6
ANDHRA PRADESH,2001, FEMALE VICTIMS,38,15,43,269,175,67,607
ARUNACHAL PRADESH,2001, FEMALE VICTIMS,0,0,0,10,4,2,16
ASSAM,2001, FEMALE VICTIMS,4,8,23,45,37,11,128
BIHAR,2001, FEMALE VICTIMS,0,0,40,191,123,12,366
CHANDIGARH,2001, FEMALE VICTIMS,0,0,0,1,1,3,5
CHHATTISGARH,2001, FEMALE VICTIMS,38,14,38,214,182,63,549
DELHI,2001, FEMALE VICTIMS,12,2,9,74,41,14,152
GOA,2001, FEMALE VICTIMS,0,0,0,4,8,1,13
GUJARAT,2001, FEMALE VICTIMS,57,9,8,132,131,26,363
HARYANA,2001, FEMALE VICTIMS,12,1,15,67,42,6,143
HIMACHAL PRADESH,2001, FEMALE VICTIMS,1,1,1,11,19,6,39
JAMMU & KASHMIR,2001, FEMALE VICTIMS,2,13,27,68,53,24,187
JHARKHAND,2001, FEMALE VICTIMS,0,0,39,126,102,24,291
KARNATAKA,2001, FEMALE VICTIMS,38,13,24,250,201,51,577
KERALA,2001, FEMALE VICTIMS,36,5,8,25,58,24,156
LAKSHADWEEP,2001, FEMALE VICTIMS,1,1,0,0,0,0,2
MADHYA PRADESH,2001, FEMALE VICTIMS,41,13,37,281,219,31,622
MAHARASHTRA,2001, FEMALE VICTIMS,76,28,41,555,290,78,1068
MANIPUR,2001, FEMALE VICTIMS,2,0,0,2,3,1,8
MEGHALAYA,2001, FEMALE VICTIMS,0,0,0,4,2,0,6
MIZORAM,2001, FEMALE VICTIMS,0,0,0,9,3,0,12
NAGALAND,2001, FEMALE VICTIMS,0,0,2,0,0,0,2
ODISHA,2001, FEMALE VICTIMS,0,0,13,140,81,26,260
PUDUCHERRY,2001, FEMALE VICTIMS,0,0,1,5,4,0,10
PUNJAB,2001, FEMALE VICTIMS,3,1,21,90,77,11,203
RAJASTHAN,2001, FEMALE VICTIMS,8,4,15,108,81,32,248
SIKKIM,2001, FEMALE VICTIMS,0,0,0,1,5,0,6
TAMIL NADU,2001, FEMALE VICTIMS,5,8,113,174,191,34,525
TRIPURA,2001, FEMALE VICTIMS,0,0,2,3,2,2,9
UTTAR PRADESH,2001, FEMALE VICTIMS,10,65,103,626,417,102,1323
UTTARAKHAND,2001, FEMALE VICTIMS,2,2,1,72,29,4,110
WEST BENGAL,2001, FEMALE VICTIMS,0,0,1,213,132,12,358
ANDAMAN & NICOBAR ISLANDS,2001, MALE VICTIMS,0,1,0,3,3,0,7
ANDHRA PRADESH,2001, MALE VICTIMS,35,59,88,827,952,215,2176
ARUNACHAL PRADESH,2001, MALE VICTIMS,0,0,0,31,32,4,67
ASSAM,2001, MALE VICTIMS,17,30,169,577,368,67,1228
BIHAR,2001, MALE VICTIMS,2,2,156,1484,1406,227,3277
CHANDIGARH,2001, MALE VICTIMS,0,0,0,4,5,1,10
CHHATTISGARH,2001, MALE VICTIMS,30,12,30,341,553,142,1108
DADRA & NAGAR HAVELI,2001, MALE VICTIMS,0,0,0,1,2,0,3
DELHI,2001, MALE VICTIMS,13,10,12,231,128,28,422
GOA,2001, MALE VICTIMS,1,0,0,11,10,2,24
GUJARAT,2001, MALE VICTIMS,50,11,18,335,416,87,917
HARYANA,2001, MALE VICTIMS,24,11,47,291,264,38,675
HIMACHAL PRADESH,2001, MALE VICTIMS,3,0,1,29,42,8,83
JAMMU & KASHMIR,2001, MALE VICTIMS,8,37,160,385,468,167,1225
JHARKHAND,2001, MALE VICTIMS,4,3,121,470,482,136,1216
KARNATAKA,2001, MALE VICTIMS,42,9,36,450,434,130,1101
KERALA,2001, MALE VICTIMS,27,8,9,88,146,55,333
MADHYA PRADESH,2001, MALE VICTIMS,32,25,129,693,854,70,1803
MAHARASHTRA,2001, MALE VICTIMS,113,28,39,740,743,219,1882
MANIPUR,2001, MALE VICTIMS,0,0,8,137,70,10,225
MEGHALAYA,2001, MALE VICTIMS,0,0,0,112,50,1,163
MIZORAM,2001, MALE VICTIMS,0,0,3,8,6,2,19
NAGALAND,2001, MALE VICTIMS,0,1,3,64,36,3,107
ODISHA,2001, MALE VICTIMS,0,2,43,350,304,46,745
PUDUCHERRY,2001, MALE VICTIMS,0,0,0,5,7,3,15
PUNJAB,2001, MALE VICTIMS,7,9,35,268,222,43,584
RAJASTHAN,2001, MALE VICTIMS,10,14,32,389,481,101,1027
SIKKIM,2001, MALE VICTIMS,1,0,0,7,3,2,13
TAMIL NADU,2001, MALE VICTIMS,3,8,136,391,463,136,1137
TRIPURA,2001, MALE VICTIMS,0,6,15,90,100,20,231
UTTAR PRADESH,2001, MALE VICTIMS,29,93,189,3098,2726,722,6857
UTTARAKHAND,2001, MALE VICTIMS,2,3,3,52,184,27,271
WEST BENGAL,2001, MALE VICTIMS,1,2,2,676,552,82,1315
ANDAMAN & NICOBAR ISLANDS,2002, FEMALE VICTIMS,0,0,1,2,4,0,7
ANDHRA PRADESH,2002, FEMALE VICTIMS,5,17,3,371,185,81,662
ARUNACHAL PRADESH,2002, FEMALE VICTIMS,0,0,0,3,1,0,4
ASSAM,2002, FEMALE VICTIMS,0,0,0,64,43,4,111
BIHAR,2002, FEMALE VICTIMS,3,0,2,242,144,6,397
CHANDIGARH,2002, FEMALE VICTIMS,1,0,0,3,3,2,9
CHHATTISGARH,2002, FEMALE VICTIMS,5,2,2,111,82,26,228
DADRA & NAGAR HAVELI,2002, FEMALE VICTIMS,0,0,0,0,1,0,1
DAMAN & DIU,2002, FEMALE VICTIMS,0,0,0,2,0,0,2
DELHI,2002, FEMALE VICTIMS,6,3,2,69,36,14,130
GOA,2002, FEMALE VICTIMS,0,0,0,1,2,4,7
GUJARAT,2002, FEMALE VICTIMS,57,25,11,252,182,67,594
HARYANA,2002, FEMALE VICTIMS,2,3,1,97,47,6,156
HIMACHAL PRADESH,2002, FEMALE VICTIMS,2,0,2,19,10,1,34
JAMMU & KASHMIR,2002, FEMALE VICTIMS,0,0,0,71,85,7,163
JHARKHAND,2002, FEMALE VICTIMS,1,1,1,140,107,56,306
KARNATAKA,2002, FEMALE VICTIMS,7,0,3,346,214,25,595
KERALA,2002, FEMALE VICTIMS,44,5,2,31,46,27,155
MADHYA PRADESH,2002, FEMALE VICTIMS,2,5,7,258,194,71,537
MAHARASHTRA,2002, FEMALE VICTIMS,75,27,18,475,293,78,966
MANIPUR,2002, FEMALE VICTIMS,0,0,0,7,6,1,14
MEGHALAYA,2002, FEMALE VICTIMS,1,0,0,3,20,1,25
MIZORAM,2002, FEMALE VICTIMS,0,0,0,8,1,0,9
NAGALAND,2002, FEMALE VICTIMS,0,0,0,1,2,0,3
ODISHA,2002, FEMALE VICTIMS,3,0,0,201,117,25,346
PUDUCHERRY,2002, FEMALE VICTIMS,1,0,0,1,8,1,11
PUNJAB,2002, FEMALE VICTIMS,1,2,2,74,57,5,141
RAJASTHAN,2002, FEMALE VICTIMS,10,1,1,131,102,16,261
TAMIL NADU,2002, FEMALE VICTIMS,18,8,2,259,165,66,518
TRIPURA,2002, FEMALE VICTIMS,0,0,0,10,2,0,12
UTTAR PRADESH,2002, FEMALE VICTIMS,7,57,84,724,508,73,1453
UTTARAKHAND,2002, FEMALE VICTIMS,0,2,2,23,37,3,67
WEST BENGAL,2002, FEMALE VICTIMS,3,0,0,188,72,9,272
ANDAMAN & NICOBAR ISLANDS,2002, MALE VICTIMS,0,0,0,4,4,2,10
ANDHRA PRADESH,2002, MALE VICTIMS,7,3,10,949,826,194,1989
ARUNACHAL PRADESH,2002, MALE VICTIMS,0,0,0,31,26,0,57
ASSAM,2002, MALE VICTIMS,2,0,0,763,356,21,1142
BIHAR,2002, MALE VICTIMS,4,3,3,1874,1395,155,3434
CHANDIGARH,2002, MALE VICTIMS,2,0,0,9,10,1,22
CHHATTISGARH,2002, MALE VICTIMS,19,5,2,153,357,80,616
DADRA & NAGAR HAVELI,2002, MALE VICTIMS,0,0,0,2,7,1,10
DAMAN & DIU,2002, MALE VICTIMS,0,0,0,3,3,0,6
DELHI,2002, MALE VICTIMS,8,8,8,243,118,26,411
GOA,2002, MALE VICTIMS,1,0,1,9,7,6,24
GUJARAT,2002, MALE VICTIMS,72,16,31,723,702,189,1733
HARYANA,2002, MALE VICTIMS,4,8,4,336,271,32,655
HIMACHAL PRADESH,2002, MALE VICTIMS,3,1,2,36,43,13,98
JAMMU & KASHMIR,2002, MALE VICTIMS,0,0,2,493,562,87,1144
JHARKHAND,2002, MALE VICTIMS,2,1,2,495,444,238,1182
KARNATAKA,2002, MALE VICTIMS,11,3,4,480,480,131,1109
KERALA,2002, MALE VICTIMS,20,4,5,87,133,50,299
MADHYA PRADESH,2002, MALE VICTIMS,6,7,67,891,743,144,1858
MAHARASHTRA,2002, MALE VICTIMS,81,27,27,716,899,275,2025
MANIPUR,2002, MALE VICTIMS,0,0,0,123,80,5,208
MEGHALAYA,2002, MALE VICTIMS,0,0,2,76,78,3,159
MIZORAM,2002, MALE VICTIMS,0,0,0,15,3,2,20
NAGALAND,2002, MALE VICTIMS,0,2,7,71,24,1,105
ODISHA,2002, MALE VICTIMS,2,2,0,378,372,48,802
PUDUCHERRY,2002, MALE VICTIMS,1,0,0,6,12,1,20
PUNJAB,2002, MALE VICTIMS,3,3,2,245,334,44,631
RAJASTHAN,2002, MALE VICTIMS,5,1,2,432,531,92,1063
SIKKIM,2002, MALE VICTIMS,0,0,2,4,7,0,13
TAMIL NADU,2002, MALE VICTIMS,11,4,2,512,543,197,1269
TRIPURA,2002, MALE VICTIMS,0,0,0,95,72,22,189
UTTAR PRADESH,2002, MALE VICTIMS,29,134,227,2824,2378,493,6085
UTTARAKHAND,2002, MALE VICTIMS,0,2,1,77,169,19,268
WEST BENGAL,2002, MALE VICTIMS,0,0,0,664,465,52,1181
ANDAMAN & NICOBAR ISLANDS,2003, FEMALE VICTIMS,1,0,0,2,5,1,9
ANDHRA PRADESH,2003, FEMALE VICTIMS,8,8,12,378,257,74,737
ARUNACHAL PRADESH,2003, FEMALE VICTIMS,0,0,0,0,0,0,0
ASSAM,2003, FEMALE VICTIMS,0,0,0,68,31,4,103
BIHAR,2003, FEMALE VICTIMS,3,0,2,235,147,6,393
CHANDIGARH,2003, FEMALE VICTIMS,1,1,0,3,0,1,6
CHHATTISGARH,2003, FEMALE VICTIMS,9,4,1,84,88,30,216
DADRA & NAGAR HAVELI,2003, FEMALE VICTIMS,0,0,0,1,1,1,3
DAMAN & DIU,2003, FEMALE VICTIMS,0,0,0,0,0,0,0
DELHI,2003, FEMALE VICTIMS,8,6,7,44,43,23,131
GOA,2003, FEMALE VICTIMS,0,0,0,5,5,4,14
GUJARAT,2003, FEMALE VICTIMS,29,1,3,160,130,33,356
HARYANA,2003, FEMALE VICTIMS,1,1,7,93,41,8,151
HIMACHAL PRADESH,2003, FEMALE VICTIMS,0,0,1,12,16,5,34
JAMMU & KASHMIR,2003, FEMALE VICTIMS,0,0,0,57,42,3,102
JHARKHAND,2003, FEMALE VICTIMS,2,1,1,177,185,30,396
KARNATAKA,2003, FEMALE VICTIMS,50,12,21,249,154,39,525
KERALA,2003, FEMALE VICTIMS,15,3,3,28,55,22,126
MADHYA PRADESH,2003, FEMALE VICTIMS,16,4,39,194,151,50,454
MAHARASHTRA,2003, FEMALE VICTIMS,79,22,18,533,274,70,996
MANIPUR,2003, FEMALE VICTIMS,1,0,0,8,2,0,11
MEGHALAYA,2003, FEMALE VICTIMS,0,0,2,4,3,1,10
MIZORAM,2003, FEMALE VICTIMS,0,0,0,5,4,0,9
NAGALAND,2003, FEMALE VICTIMS,0,0,0,5,1,0,6
ODISHA,2003, FEMALE VICTIMS,3,0,3,178,128,21,333
PUDUCHERRY,2003, FEMALE VICTIMS,0,1,0,3,2,2,8
PUNJAB,2003, FEMALE VICTIMS,3,2,2,89,61,18,175
RAJASTHAN,2003, FEMALE VICTIMS,2,3,3,123,106,34,271
SIKKIM,2003, FEMALE VICTIMS,1,0,0,4,1,0,6
TAMIL NADU,2003, FEMALE VICTIMS,7,7,25,239,182,83,543
TRIPURA,2003, FEMALE VICTIMS,0,0,0,18,5,0,23
UTTAR PRADESH,2003, FEMALE VICTIMS,8,58,86,427,345,75,999
UTTARAKHAND,2003, FEMALE VICTIMS,0,0,2,28,30,2,62
WEST BENGAL,2003, FEMALE VICTIMS,2,2,2,186,95,10,297
ANDAMAN & NICOBAR ISLANDS,2003, MALE VICTIMS,0,0,0,6,5,1,12
ANDHRA PRADESH,2003, MALE VICTIMS,17,31,43,992,887,207,2177
ARUNACHAL PRADESH,2003, MALE VICTIMS,0,0,0,64,13,0,77
ASSAM,2003, MALE VICTIMS,2,0,0,571,460,55,1088
BIHAR,2003, MALE VICTIMS,2,2,3,1637,1536,199,3379
CHANDIGARH,2003, MALE VICTIMS,0,1,0,5,9,0,15
CHHATTISGARH,2003, MALE VICTIMS,16,8,2,228,262,65,581
DADRA & NAGAR HAVELI,2003, MALE VICTIMS,0,0,0,3,4,1,8
DAMAN & DIU,2003, MALE VICTIMS,0,0,0,0,3,3,6
DELHI,2003, MALE VICTIMS,11,10,12,210,103,25,371
GOA,2003, MALE VICTIMS,0,0,0,6,12,2,20
GUJARAT,2003, MALE VICTIMS,32,5,13,297,379,82,808
HARYANA,2003, MALE VICTIMS,2,1,12,308,243,31,597
HIMACHAL PRADESH,2003, MALE VICTIMS,5,2,1,31,53,4,96
JAMMU & KASHMIR,2003, MALE VICTIMS,0,0,0,375,559,79,1013
JHARKHAND,2003, MALE VICTIMS,5,2,1,506,487,85,1086
KARNATAKA,2003, MALE VICTIMS,41,11,50,399,439,111,1051
KERALA,2003, MALE VICTIMS,7,1,2,92,151,56,309
MADHYA PRADESH,2003, MALE VICTIMS,25,21,60,790,773,104,1773
MAHARASHTRA,2003, MALE VICTIMS,63,22,23,717,826,304,1955
MANIPUR,2003, MALE VICTIMS,0,0,0,109,56,9,174
MEGHALAYA,2003, MALE VICTIMS,1,0,11,60,90,3,165
MIZORAM,2003, MALE VICTIMS,1,0,4,11,20,1,37
NAGALAND,2003, MALE VICTIMS,0,0,0,65,20,0,85
ODISHA,2003, MALE VICTIMS,5,4,10,363,322,65,769
PUDUCHERRY,2003, MALE VICTIMS,1,0,0,8,10,3,22
PUNJAB,2003, MALE VICTIMS,9,3,6,249,271,56,594
RAJASTHAN,2003, MALE VICTIMS,11,4,3,437,456,102,1013
SIKKIM,2003, MALE VICTIMS,0,0,1,5,2,2,10
TAMIL NADU,2003, MALE VICTIMS,4,4,15,357,534,197,1111
TRIPURA,2003, MALE VICTIMS,0,0,0,117,84,30,231
UTTAR PRADESH,2003, MALE VICTIMS,27,87,206,2011,1542,412,4285
UTTARAKHAND,2003, MALE VICTIMS,0,0,1,87,127,16,231
WEST BENGAL,2003, MALE VICTIMS,1,0,2,606,506,52,1167
ANDAMAN & NICOBAR ISLANDS,2004, FEMALE VICTIMS,0,0,0,0,5,0,5
ANDHRA PRADESH,2004, FEMALE VICTIMS,13,10,14,301,254,63,655
ARUNACHAL PRADESH,2004, FEMALE VICTIMS,0,0,0,0,2,0,2
ASSAM,2004, FEMALE VICTIMS,0,0,0,55,25,4,84
BIHAR,2004, FEMALE VICTIMS,2,4,0,269,140,10,425
CHANDIGARH,2004, FEMALE VICTIMS,2,0,0,3,3,0,8
CHHATTISGARH,2004, FEMALE VICTIMS,5,5,7,96,124,32,269
DADRA & NAGAR HAVELI,2004, FEMALE VICTIMS,2,0,0,0,0,0,2
DAMAN & DIU,2004, FEMALE VICTIMS,0,0,0,1,0,0,1
DELHI,2004, FEMALE VICTIMS,14,7,7,51,30,16,125
GOA,2004, FEMALE VICTIMS,0,1,0,7,4,5,17
GUJARAT,2004, FEMALE VICTIMS,53,2,6,157,97,25,340
HARYANA,2004, FEMALE VICTIMS,0,0,2,100,51,6,159
HIMACHAL PRADESH,2004, FEMALE VICTIMS,1,0,3,7,10,4,25
JAMMU & KASHMIR,2004, FEMALE VICTIMS,1,0,0,58,36,12,107
JHARKHAND,2004, FEMALE VICTIMS,2,1,1,179,186,30,399
KARNATAKA,2004, FEMALE VICTIMS,23,0,2,313,172,51,561
KERALA,2004, FEMALE VICTIMS,16,6,2,26,58,29,137
MADHYA PRADESH,2004, FEMALE VICTIMS,1,4,18,262,158,51,494
MAHARASHTRA,2004, FEMALE VICTIMS,69,10,16,523,299,87,1004
MANIPUR,2004, FEMALE VICTIMS,0,0,0,8,6,1,15
MEGHALAYA,2004, FEMALE VICTIMS,0,0,1,6,1,0,8
MIZORAM,2004, FEMALE VICTIMS,0,0,0,2,1,1,4
NAGALAND,2004, FEMALE VICTIMS,0,0,0,8,9,0,17
ODISHA,2004, FEMALE VICTIMS,1,3,0,221,114,18,357
PUDUCHERRY,2004, FEMALE VICTIMS,0,0,0,1,2,0,3
PUNJAB,2004, FEMALE VICTIMS,13,4,2,84,74,17,194
RAJASTHAN,2004, FEMALE VICTIMS,4,2,2,146,99,34,287
SIKKIM,2004, FEMALE VICTIMS,2,0,0,2,0,1,5
TAMIL NADU,2004, FEMALE VICTIMS,34,6,0,240,157,56,493
TRIPURA,2004, FEMALE VICTIMS,0,1,0,27,10,6,44
UTTAR PRADESH,2004, FEMALE VICTIMS,56,71,124,613,451,86,1401
UTTARAKHAND,2004, FEMALE VICTIMS,2,0,0,22,18,5,47
WEST BENGAL,2004, FEMALE VICTIMS,1,1,0,218,191,14,425
ANDAMAN & NICOBAR ISLANDS,2004, MALE VICTIMS,1,0,0,2,5,2,10
ANDHRA PRADESH,2004, MALE VICTIMS,22,15,15,856,855,222,1985
ARUNACHAL PRADESH,2004, MALE VICTIMS,0,0,0,36,26,3,65
ASSAM,2004, MALE VICTIMS,1,0,0,636,425,68,1130
BIHAR,2004, MALE VICTIMS,2,9,4,1906,1424,178,3523
CHANDIGARH,2004, MALE VICTIMS,0,0,1,5,6,2,14
CHHATTISGARH,2004, MALE VICTIMS,15,6,23,235,288,91,658
DADRA & NAGAR HAVELI,2004, MALE VICTIMS,0,0,1,3,4,1,9
DAMAN & DIU,2004, MALE VICTIMS,0,0,0,1,1,0,2
DELHI,2004, MALE VICTIMS,20,14,15,170,134,32,385
GOA,2004, MALE VICTIMS,1,0,0,8,13,3,25
GUJARAT,2004, MALE VICTIMS,31,5,6,315,393,79,829
HARYANA,2004, MALE VICTIMS,0,1,20,278,244,40,583
HIMACHAL PRADESH,2004, MALE VICTIMS,2,3,0,30,34,16,85
JAMMU & KASHMIR,2004, MALE VICTIMS,0,0,0,438,374,70,882
JHARKHAND,2004, MALE VICTIMS,5,2,1,507,489,85,1089
KARNATAKA,2004, MALE VICTIMS,24,3,2,432,433,112,1006
KERALA,2004, MALE VICTIMS,24,2,3,68,131,62,290
MADHYA PRADESH,2004, MALE VICTIMS,7,18,96,826,715,224,1886
MAHARASHTRA,2004, MALE VICTIMS,56,18,36,653,806,204,1773
MANIPUR,2004, MALE VICTIMS,0,0,0,117,52,9,178
MEGHALAYA,2004, MALE VICTIMS,0,0,0,97,51,1,149
MIZORAM,2004, MALE VICTIMS,0,0,0,13,13,5,31
NAGALAND,2004, MALE VICTIMS,0,0,0,28,28,0,56
ODISHA,2004, MALE VICTIMS,1,1,3,389,341,45,780
PUDUCHERRY,2004, MALE VICTIMS,1,0,0,11,8,2,22
PUNJAB,2004, MALE VICTIMS,10,4,9,250,275,60,608
RAJASTHAN,2004, MALE VICTIMS,4,4,5,422,443,127,1005
SIKKIM,2004, MALE VICTIMS,1,0,0,2,8,2,13
TAMIL NADU,2004, MALE VICTIMS,32,7,4,372,447,189,1051
TRIPURA,2004, MALE VICTIMS,0,2,2,97,65,16,182
UTTAR PRADESH,2004, MALE VICTIMS,60,147,223,2224,2146,464,5264
UTTARAKHAND,2004, MALE VICTIMS,2,0,0,108,90,20,220
WEST BENGAL,2004, MALE VICTIMS,0,0,0,518,439,51,1008
ANDAMAN & NICOBAR ISLANDS,2005, FEMALE VICTIMS,0,0,0,1,3,0,4
ANDHRA PRADESH,2005, FEMALE VICTIMS,14,7,7,324,302,68,722
ARUNACHAL PRADESH,2005, FEMALE VICTIMS,0,0,0,1,0,0,1
ASSAM,2005, FEMALE VICTIMS,0,0,0,42,19,4,65
BIHAR,2005, FEMALE VICTIMS,9,2,3,310,102,16,442
CHANDIGARH,2005, FEMALE VICTIMS,1,0,0,1,0,1,3
CHHATTISGARH,2005, FEMALE VICTIMS,4,6,5,125,148,35,323
DELHI,2005, FEMALE VICTIMS,7,3,3,87,43,15,158
GOA,2005, FEMALE VICTIMS,3,0,0,7,3,1,14
GUJARAT,2005, FEMALE VICTIMS,29,8,2,125,151,31,346
HARYANA,2005, FEMALE VICTIMS,3,1,4,80,40,15,143
HIMACHAL PRADESH,2005, FEMALE VICTIMS,3,0,3,13,16,1,36
JAMMU & KASHMIR,2005, FEMALE VICTIMS,2,0,0,64,36,0,102
JHARKHAND,2005, FEMALE VICTIMS,0,6,44,62,45,16,173
KARNATAKA,2005, FEMALE VICTIMS,17,2,3,306,206,51,585
KERALA,2005, FEMALE VICTIMS,36,7,0,25,49,30,147
LAKSHADWEEP,2005, FEMALE VICTIMS,0,0,0,1,0,0,1
MADHYA PRADESH,2005, FEMALE VICTIMS,10,15,20,248,179,56,528
MAHARASHTRA,2005, FEMALE VICTIMS,77,17,19,488,312,67,980
MANIPUR,2005, FEMALE VICTIMS,1,1,1,12,4,0,19
MEGHALAYA,2005, FEMALE VICTIMS,1,0,4,8,4,2,19
MIZORAM,2005, FEMALE VICTIMS,0,0,0,2,1,1,4
NAGALAND,2005, FEMALE VICTIMS,0,0,0,13,2,2,17
ODISHA,2005, FEMALE VICTIMS,1,2,3,162,126,32,326
PUDUCHERRY,2005, FEMALE VICTIMS,0,0,0,5,1,3,9
PUNJAB,2005, FEMALE VICTIMS,4,4,1,87,78,13,187
RAJASTHAN,2005, FEMALE VICTIMS,14,4,9,124,116,29,296
SIKKIM,2005, FEMALE VICTIMS,0,0,0,2,2,0,4
TAMIL NADU,2005, FEMALE VICTIMS,32,7,0,199,159,65,462
TRIPURA,2005, FEMALE VICTIMS,1,0,0,49,10,4,64
UTTAR PRADESH,2005, FEMALE VICTIMS,19,59,63,695,447,71,1354
UTTARAKHAND,2005, FEMALE VICTIMS,2,0,0,25,25,1,53
WEST BENGAL,2005, FEMALE VICTIMS,0,1,0,269,81,14,365
ANDAMAN & NICOBAR ISLANDS,2005, MALE VICTIMS,1,0,0,4,5,1,11
ANDHRA PRADESH,2005, MALE VICTIMS,24,14,21,953,949,245,2206
ARUNACHAL PRADESH,2005, MALE VICTIMS,0,0,0,58,20,2,80
ASSAM,2005, MALE VICTIMS,0,4,9,672,372,72,1129
BIHAR,2005, MALE VICTIMS,5,8,10,1850,983,173,3029
CHANDIGARH,2005, MALE VICTIMS,2,0,0,6,7,0,15
CHHATTISGARH,2005, MALE VICTIMS,7,8,7,280,337,88,727
DADRA & NAGAR HAVELI,2005, MALE VICTIMS,1,0,1,2,1,2,7
DAMAN & DIU,2005, MALE VICTIMS,0,1,0,4,0,0,5
DELHI,2005, MALE VICTIMS,10,9,4,197,130,25,375
GOA,2005, MALE VICTIMS,0,1,0,7,23,4,35
GUJARAT,2005, MALE VICTIMS,41,9,10,293,320,84,757
HARYANA,2005, MALE VICTIMS,6,7,17,286,286,67,669
HIMACHAL PRADESH,2005, MALE VICTIMS,3,0,1,27,37,14,82
JAMMU & KASHMIR,2005, MALE VICTIMS,2,0,0,361,236,45,644
JHARKHAND,2005, MALE VICTIMS,5,23,69,390,749,114,1350
KARNATAKA,2005, MALE VICTIMS,22,0,3,473,459,131,1088
KERALA,2005, MALE VICTIMS,18,4,4,62,134,62,284
MADHYA PRADESH,2005, MALE VICTIMS,25,20,60,771,795,229,1900
MAHARASHTRA,2005, MALE VICTIMS,77,26,26,634,777,225,1765
MANIPUR,2005, MALE VICTIMS,0,0,0,174,96,6,276
MEGHALAYA,2005, MALE VICTIMS,2,1,3,49,60,4,119
MIZORAM,2005, MALE VICTIMS,0,0,0,13,13,5,31
NAGALAND,2005, MALE VICTIMS,0,0,0,35,36,3,74
ODISHA,2005, MALE VICTIMS,2,1,1,373,375,55,807
PUDUCHERRY,2005, MALE VICTIMS,0,0,0,3,7,0,10
PUNJAB,2005, MALE VICTIMS,7,5,5,244,241,55,557
RAJASTHAN,2005, MALE VICTIMS,7,7,16,399,426,95,950
SIKKIM,2005, MALE VICTIMS,0,1,0,1,2,1,5
TAMIL NADU,2005, MALE VICTIMS,22,3,3,353,485,183,1049
TRIPURA,2005, MALE VICTIMS,0,0,0,42,42,10,94
UTTAR PRADESH,2005, MALE VICTIMS,25,65,159,2425,1854,483,5011
UTTARAKHAND,2005, MALE VICTIMS,2,2,0,102,103,28,237
WEST BENGAL,2005, MALE VICTIMS,0,1,0,673,355,60,1089
ANDAMAN & NICOBAR ISLANDS,2006, FEMALE VICTIMS,0,0,0,0,1,0,1
ANDHRA PRADESH,2006, FEMALE VICTIMS,16,9,11,322,306,80,744
ARUNACHAL PRADESH,2006, FEMALE VICTIMS,0,0,0,0,0,0,0
ASSAM,2006, FEMALE VICTIMS,0,0,0,43,31,2,76
BIHAR,2006, FEMALE VICTIMS,2,1,2,282,118,8,413
CHANDIGARH,2006, FEMALE VICTIMS,0,0,0,0,1,3,4
CHHATTISGARH,2006, FEMALE VICTIMS,4,7,10,159,116,40,336
DADRA & NAGAR HAVELI,2006, FEMALE VICTIMS,0,0,0,2,1,0,3
DAMAN & DIU,2006, FEMALE VICTIMS,2,0,0,0,0,0,2
DELHI,2006, FEMALE VICTIMS,12,2,8,75,23,8,128
GOA,2006, FEMALE VICTIMS,0,0,1,4,2,3,10
GUJARAT,2006, FEMALE VICTIMS,34,4,3,150,146,29,366
HARYANA,2006, FEMALE VICTIMS,0,1,2,90,55,8,156
HIMACHAL PRADESH,2006, FEMALE VICTIMS,1,1,0,11,13,5,31
JAMMU & KASHMIR,2006, FEMALE VICTIMS,0,1,5,37,32,1,76
JHARKHAND,2006, FEMALE VICTIMS,1,1,38,83,58,33,214
KARNATAKA,2006, FEMALE VICTIMS,30,3,2,294,195,64,588
KERALA,2006, FEMALE VICTIMS,35,3,2,30,41,27,138
MADHYA PRADESH,2006, FEMALE VICTIMS,14,14,22,200,186,74,510
MAHARASHTRA,2006, FEMALE VICTIMS,75,14,27,482,321,76,995
MANIPUR,2006, FEMALE VICTIMS,0,0,1,5,2,1,9
MEGHALAYA,2006, FEMALE VICTIMS,1,0,0,7,3,0,11
MIZORAM,2006, FEMALE VICTIMS,0,0,0,3,0,0,3
NAGALAND,2006, FEMALE VICTIMS,0,0,0,3,3,2,8
ODISHA,2006, FEMALE VICTIMS,3,0,2,192,175,12,384
PUDUCHERRY,2006, FEMALE VICTIMS,0,0,0,3,5,1,9
PUNJAB,2006, FEMALE VICTIMS,3,5,4,120,81,24,237
RAJASTHAN,2006, FEMALE VICTIMS,11,6,6,113,83,30,249
SIKKIM,2006, FEMALE VICTIMS,0,0,0,3,3,1,7
TAMIL NADU,2006, FEMALE VICTIMS,33,9,4,206,181,82,515
TRIPURA,2006, FEMALE VICTIMS,0,0,0,22,8,4,34
UTTAR PRADESH,2006, FEMALE VICTIMS,11,63,82,408,306,57,927
UTTARAKHAND,2006, FEMALE VICTIMS,2,0,1,17,33,2,55
WEST BENGAL,2006, FEMALE VICTIMS,0,0,0,335,95,17,447
ANDAMAN & NICOBAR ISLANDS,2006, MALE VICTIMS,0,0,0,1,1,2,4
ANDHRA PRADESH,2006, MALE VICTIMS,12,11,4,1045,812,312,2196
ARUNACHAL PRADESH,2006, MALE VICTIMS,0,0,0,40,20,0,60
ASSAM,2006, MALE VICTIMS,0,4,7,648,391,81,1131
BIHAR,2006, MALE VICTIMS,1,1,5,1651,1075,103,2836
CHANDIGARH,2006, MALE VICTIMS,1,0,0,2,5,2,10
CHHATTISGARH,2006, MALE VICTIMS,8,5,14,268,366,101,762
DADRA & NAGAR HAVELI,2006, MALE VICTIMS,1,0,0,1,3,1,6
DAMAN & DIU,2006, MALE VICTIMS,0,0,0,3,2,0,5
DELHI,2006, MALE VICTIMS,18,10,16,208,88,20,360
GOA,2006, MALE VICTIMS,0,0,1,8,13,8,30
GUJARAT,2006, MALE VICTIMS,46,13,10,347,365,67,848
HARYANA,2006, MALE VICTIMS,0,8,19,314,354,48,743
HIMACHAL PRADESH,2006, MALE VICTIMS,3,0,0,37,51,7,98
JAMMU & KASHMIR,2006, MALE VICTIMS,2,0,2,287,258,16,565
JHARKHAND,2006, MALE VICTIMS,11,17,71,474,480,225,1278
KARNATAKA,2006, MALE VICTIMS,28,10,6,463,482,100,1089
KERALA,2006, MALE VICTIMS,30,1,1,72,133,51,288
MADHYA PRADESH,2006, MALE VICTIMS,34,22,54,700,722,288,1820
MAHARASHTRA,2006, MALE VICTIMS,84,24,27,726,814,291,1966
MANIPUR,2006, MALE VICTIMS,0,2,4,122,85,16,229
MEGHALAYA,2006, MALE VICTIMS,1,0,5,75,62,3,146
MIZORAM,2006, MALE VICTIMS,0,0,0,17,5,0,22
NAGALAND,2006, MALE VICTIMS,4,1,4,74,32,0,115
ODISHA,2006, MALE VICTIMS,0,4,9,368,360,42,783
PUDUCHERRY,2006, MALE VICTIMS,0,0,1,9,9,2,21
PUNJAB,2006, MALE VICTIMS,7,1,6,266,247,87,614
RAJASTHAN,2006, MALE VICTIMS,19,16,19,392,428,115,989
SIKKIM,2006, MALE VICTIMS,0,0,4,2,5,3,14
TAMIL NADU,2006, MALE VICTIMS,15,7,2,286,439,154,903
TRIPURA,2006, MALE VICTIMS,1,2,0,49,65,14,131
UTTAR PRADESH,2006, MALE VICTIMS,23,98,149,2405,1707,453,4835
UTTARAKHAND,2006, MALE VICTIMS,0,2,5,79,134,10,230
WEST BENGAL,2006, MALE VICTIMS,1,0,2,546,394,52,995
ANDAMAN & NICOBAR ISLANDS,2007, FEMALE VICTIMS,0,0,0,3,2,1,6
ANDHRA PRADESH,2007, FEMALE VICTIMS,26,16,10,415,352,67,886
ARUNACHAL PRADESH,2007, FEMALE VICTIMS,0,0,0,3,0,0,3
ASSAM,2007, FEMALE VICTIMS,0,0,0,51,37,0,88
BIHAR,2007, FEMALE VICTIMS,4,0,15,237,120,14,390
CHANDIGARH,2007, FEMALE VICTIMS,2,0,0,3,0,1,6
CHHATTISGARH,2007, FEMALE VICTIMS,3,4,3,100,129,71,310
DADRA & NAGAR HAVELI,2007, FEMALE VICTIMS,0,0,0,2,2,0,4
DAMAN & DIU,2007, FEMALE VICTIMS,0,0,0,1,0,0,1
DELHI,2007, FEMALE VICTIMS,10,3,5,71,25,13,127
GOA,2007, FEMALE VICTIMS,2,0,0,6,4,4,16
GUJARAT,2007, FEMALE VICTIMS,33,5,5,117,126,28,314
HARYANA,2007, FEMALE VICTIMS,14,8,9,84,45,7,167
HIMACHAL PRADESH,2007, FEMALE VICTIMS,2,1,1,15,14,2,35
JAMMU & KASHMIR,2007, FEMALE VICTIMS,0,0,0,26,12,2,40
JHARKHAND,2007, FEMALE VICTIMS,2,1,5,87,115,27,237
KARNATAKA,2007, FEMALE VICTIMS,17,4,6,289,148,41,505
KERALA,2007, FEMALE VICTIMS,22,1,4,34,52,28,141
MADHYA PRADESH,2007, FEMALE VICTIMS,33,7,11,253,183,64,551
MAHARASHTRA,2007, FEMALE VICTIMS,73,15,19,521,297,89,1014
MANIPUR,2007, FEMALE VICTIMS,0,0,2,8,8,2,20
MEGHALAYA,2007, FEMALE VICTIMS,2,0,0,3,2,0,7
MIZORAM,2007, FEMALE VICTIMS,0,1,1,11,5,0,18
NAGALAND,2007, FEMALE VICTIMS,1,0,1,9,3,0,14
ODISHA,2007, FEMALE VICTIMS,2,2,4,242,116,6,372
PUDUCHERRY,2007, FEMALE VICTIMS,1,0,0,4,3,2,10
PUNJAB,2007, FEMALE VICTIMS,3,5,4,120,75,18,225
RAJASTHAN,2007, FEMALE VICTIMS,10,12,6,143,123,25,319
SIKKIM,2007, FEMALE VICTIMS,0,1,0,2,0,0,3
TAMIL NADU,2007, FEMALE VICTIMS,31,8,3,261,215,86,604
TRIPURA,2007, FEMALE VICTIMS,3,0,2,19,18,8,50
UTTAR PRADESH,2007, FEMALE VICTIMS,24,63,74,382,288,68,899
UTTARAKHAND,2007, FEMALE VICTIMS,2,3,0,53,12,7,77
WEST BENGAL,2007, FEMALE VICTIMS,7,0,3,441,175,21,647
ANDAMAN & NICOBAR ISLANDS,2007, MALE VICTIMS,0,0,0,3,4,2,9
ANDHRA PRADESH,2007, MALE VICTIMS,19,8,29,874,828,206,1964
ARUNACHAL PRADESH,2007, MALE VICTIMS,0,0,0,41,23,1,65
ASSAM,2007, MALE VICTIMS,0,1,1,766,421,97,1286
BIHAR,2007, MALE VICTIMS,12,23,41,1451,1012,152,2691
CHANDIGARH,2007, MALE VICTIMS,0,0,0,7,7,0,14
CHHATTISGARH,2007, MALE VICTIMS,10,11,14,281,315,156,787
DADRA & NAGAR HAVELI,2007, MALE VICTIMS,1,0,0,1,4,0,6
DAMAN & DIU,2007, MALE VICTIMS,1,1,0,3,2,4,11
DELHI,2007, MALE VICTIMS,14,5,20,205,112,28,384
GOA,2007, MALE VICTIMS,0,0,0,3,11,4,18
GUJARAT,2007, MALE VICTIMS,38,10,13,289,451,99,900
HARYANA,2007, MALE VICTIMS,19,20,29,332,322,53,775
HIMACHAL PRADESH,2007, MALE VICTIMS,3,2,1,31,46,14,97
JAMMU & KASHMIR,2007, MALE VICTIMS,0,0,0,170,140,16,326
JHARKHAND,2007, MALE VICTIMS,0,12,5,550,711,102,1380
KARNATAKA,2007, MALE VICTIMS,15,5,6,381,541,133,1081
KERALA,2007, MALE VICTIMS,17,8,1,54,115,57,252
MADHYA PRADESH,2007, MALE VICTIMS,48,27,34,697,741,217,1764
MAHARASHTRA,2007, MALE VICTIMS,92,24,27,654,723,259,1779
MANIPUR,2007, MALE VICTIMS,1,1,4,140,121,8,275
MEGHALAYA,2007, MALE VICTIMS,0,3,7,36,52,9,107
MIZORAM,2007, MALE VICTIMS,0,0,1,15,7,2,25
NAGALAND,2007, MALE VICTIMS,0,0,1,42,58,3,104
ODISHA,2007, MALE VICTIMS,4,10,11,395,405,38,863
PUDUCHERRY,2007, MALE VICTIMS,1,0,1,17,5,1,25
PUNJAB,2007, MALE VICTIMS,7,8,6,266,247,67,601
RAJASTHAN,2007, MALE VICTIMS,18,17,26,393,483,103,1040
SIKKIM,2007, MALE VICTIMS,0,0,0,3,2,1,6
TAMIL NADU,2007, MALE VICTIMS,18,6,2,346,507,228,1107
TRIPURA,2007, MALE VICTIMS,0,4,2,33,44,17,100
UTTAR PRADESH,2007, MALE VICTIMS,37,97,102,2050,1619,378,4283
UTTARAKHAND,2007, MALE VICTIMS,3,1,5,111,53,18,191
WEST BENGAL,2007, MALE VICTIMS,1,2,2,527,417,57,1006
ANDAMAN & NICOBAR ISLANDS,2008, FEMALE VICTIMS,0,2,0,0,0,0,2
ANDHRA PRADESH,2008, FEMALE VICTIMS,25,7,9,411,296,82,830
ARUNACHAL PRADESH,2008, FEMALE VICTIMS,0,0,0,0,1,0,1
ASSAM,2008, FEMALE VICTIMS,0,0,0,61,42,0,103
BIHAR,2008, FEMALE VICTIMS,12,8,12,436,151,18,637
CHANDIGARH,2008, FEMALE VICTIMS,0,0,0,3,2,1,6
CHHATTISGARH,2008, FEMALE VICTIMS,10,7,27,129,150,40,363
DADRA & NAGAR HAVELI,2008, FEMALE VICTIMS,0,1,0,0,2,1,4
DAMAN & DIU,2008, FEMALE VICTIMS,0,0,0,0,0,0,0
DELHI,2008, FEMALE VICTIMS,4,1,2,63,39,7,116
GOA,2008, FEMALE VICTIMS,2,1,0,8,4,5,20
GUJARAT,2008, FEMALE VICTIMS,24,3,2,137,145,29,340
HARYANA,2008, FEMALE VICTIMS,3,5,5,97,63,12,185
HIMACHAL PRADESH,2008, FEMALE VICTIMS,1,2,3,10,16,4,36
JAMMU & KASHMIR,2008, FEMALE VICTIMS,0,0,0,13,15,2,30
JHARKHAND,2008, FEMALE VICTIMS,2,0,1,115,123,25,266
KARNATAKA,2008, FEMALE VICTIMS,49,17,14,272,229,43,624
KERALA,2008, FEMALE VICTIMS,25,5,0,24,51,23,128
LAKSHADWEEP,2008, FEMALE VICTIMS,0,0,0,0,1,0,1
MADHYA PRADESH,2008, FEMALE VICTIMS,11,13,6,235,187,64,516
MAHARASHTRA,2008, FEMALE VICTIMS,62,11,21,541,341,73,1049
MANIPUR,2008, FEMALE VICTIMS,2,0,0,9,8,0,19
MEGHALAYA,2008, FEMALE VICTIMS,0,0,0,11,4,0,15
MIZORAM,2008, FEMALE VICTIMS,0,0,0,1,1,0,2
NAGALAND,2008, FEMALE VICTIMS,0,0,0,5,1,0,6
ODISHA,2008, FEMALE VICTIMS,2,2,0,257,237,47,545
PUDUCHERRY,2008, FEMALE VICTIMS,0,0,0,5,1,2,8
PUNJAB,2008, FEMALE VICTIMS,3,5,7,120,67,17,219
RAJASTHAN,2008, FEMALE VICTIMS,8,6,12,129,102,30,287
SIKKIM,2008, FEMALE VICTIMS,0,0,0,3,0,0,3
TAMIL NADU,2008, FEMALE VICTIMS,45,3,4,233,246,93,624
TRIPURA,2008, FEMALE VICTIMS,3,2,1,36,17,4,63
UTTAR PRADESH,2008, FEMALE VICTIMS,30,55,73,360,257,65,840
UTTARAKHAND,2008, FEMALE VICTIMS,0,0,0,29,16,3,48
WEST BENGAL,2008, FEMALE VICTIMS,1,0,5,175,53,16,250
ANDAMAN & NICOBAR ISLANDS,2008, MALE VICTIMS,0,0,0,2,2,2,6
ANDHRA PRADESH,2008, MALE VICTIMS,11,14,55,855,776,221,1932
ARUNACHAL PRADESH,2008, MALE VICTIMS,0,0,0,40,29,2,71
ASSAM,2008, MALE VICTIMS,0,1,0,790,477,55,1323
BIHAR,2008, MALE VICTIMS,25,11,48,1401,921,96,2502
CHANDIGARH,2008, MALE VICTIMS,0,0,0,7,3,1,11
CHHATTISGARH,2008, MALE VICTIMS,13,12,29,282,358,112,806
DADRA & NAGAR HAVELI,2008, MALE VICTIMS,0,0,0,0,3,2,5
DAMAN & DIU,2008, MALE VICTIMS,0,0,0,0,2,0,2
DELHI,2008, MALE VICTIMS,21,8,15,139,254,36,473
GOA,2008, MALE VICTIMS,0,0,0,10,17,6,33
GUJARAT,2008, MALE VICTIMS,23,6,8,312,378,78,805
HARYANA,2008, MALE VICTIMS,4,6,8,307,360,100,785
HIMACHAL PRADESH,2008, MALE VICTIMS,3,1,4,27,49,10,94
JAMMU & KASHMIR,2008, MALE VICTIMS,0,0,0,94,126,16,236
JHARKHAND,2008, MALE VICTIMS,2,0,6,726,624,73,1431
KARNATAKA,2008, MALE VICTIMS,58,11,18,428,532,129,1176
KERALA,2008, MALE VICTIMS,14,5,0,62,116,54,251
MADHYA PRADESH,2008, MALE VICTIMS,11,55,11,695,815,248,1835
MAHARASHTRA,2008, MALE VICTIMS,54,32,20,700,859,262,1927
MANIPUR,2008, MALE VICTIMS,3,4,3,132,95,12,249
MEGHALAYA,2008, MALE VICTIMS,0,0,0,54,48,9,111
MIZORAM,2008, MALE VICTIMS,0,0,0,23,10,0,33
NAGALAND,2008, MALE VICTIMS,0,0,0,81,57,3,141
ODISHA,2008, MALE VICTIMS,4,2,3,276,369,51,705
PUDUCHERRY,2008, MALE VICTIMS,1,0,0,12,11,3,27
PUNJAB,2008, MALE VICTIMS,7,4,6,266,247,66,596
RAJASTHAN,2008, MALE VICTIMS,13,18,36,398,467,101,1033
SIKKIM,2008, MALE VICTIMS,0,0,2,1,3,0,6
TAMIL NADU,2008, MALE VICTIMS,43,5,0,364,554,234,1200
TRIPURA,2008, MALE VICTIMS,4,7,3,21,55,13,103
UTTAR PRADESH,2008, MALE VICTIMS,30,69,119,1927,1383,331,3859
UTTARAKHAND,2008, MALE VICTIMS,1,0,2,139,46,25,213
WEST BENGAL,2008, MALE VICTIMS,1,5,9,735,662,149,1561
ANDAMAN & NICOBAR ISLANDS,2009, FEMALE VICTIMS,1,0,0,3,4,0,8
ANDHRA PRADESH,2009, FEMALE VICTIMS,18,6,7,379,299,91,800
ARUNACHAL PRADESH,2009, FEMALE VICTIMS,0,0,0,1,0,0,1
ASSAM,2009, FEMALE VICTIMS,0,0,0,62,35,0,97
BIHAR,2009, FEMALE VICTIMS,9,5,27,439,174,18,672
CHANDIGARH,2009, FEMALE VICTIMS,0,0,0,1,2,0,3
CHHATTISGARH,2009, FEMALE VICTIMS,15,2,7,124,134,44,326
DADRA & NAGAR HAVELI,2009, FEMALE VICTIMS,0,0,0,3,3,0,6
DAMAN & DIU,2009, FEMALE VICTIMS,0,0,0,1,0,0,1
DELHI,2009, FEMALE VICTIMS,13,4,2,48,41,18,126
GOA,2009, FEMALE VICTIMS,1,0,1,14,12,3,31
GUJARAT,2009, FEMALE VICTIMS,34,6,2,120,129,34,325
HARYANA,2009, FEMALE VICTIMS,0,2,2,96,106,15,221
HIMACHAL PRADESH,2009, FEMALE VICTIMS,4,1,1,10,14,9,39
JAMMU & KASHMIR,2009, FEMALE VICTIMS,0,0,0,26,16,4,46
JHARKHAND,2009, FEMALE VICTIMS,1,1,0,119,72,8,201
KARNATAKA,2009, FEMALE VICTIMS,16,9,7,335,246,66,679
KERALA,2009, FEMALE VICTIMS,17,4,5,20,45,18,109
MADHYA PRADESH,2009, FEMALE VICTIMS,18,11,11,277,231,77,625
MAHARASHTRA,2009, FEMALE VICTIMS,79,15,18,490,294,104,1000
MANIPUR,2009, FEMALE VICTIMS,2,1,1,5,7,2,18
MEGHALAYA,2009, FEMALE VICTIMS,0,0,3,16,2,1,22
MIZORAM,2009, FEMALE VICTIMS,0,0,0,3,0,0,3
NAGALAND,2009, FEMALE VICTIMS,0,0,0,9,0,0,9
ODISHA,2009, FEMALE VICTIMS,3,1,0,215,201,40,460
PUDUCHERRY,2009, FEMALE VICTIMS,1,0,0,3,5,1,10
PUNJAB,2009, FEMALE VICTIMS,15,6,8,92,68,14,203
RAJASTHAN,2009, FEMALE VICTIMS,13,8,8,150,114,35,328
SIKKIM,2009, FEMALE VICTIMS,1,0,0,3,2,0,6
TAMIL NADU,2009, FEMALE VICTIMS,45,6,5,214,224,93,587
TRIPURA,2009, FEMALE VICTIMS,4,3,3,22,21,4,57
UTTAR PRADESH,2009, FEMALE VICTIMS,38,56,71,443,266,81,955
UTTARAKHAND,2009, FEMALE VICTIMS,1,1,0,38,10,1,51
WEST BENGAL,2009, FEMALE VICTIMS,2,5,4,409,248,25,693
ANDAMAN & NICOBAR ISLANDS,2009, MALE VICTIMS,2,0,0,3,5,0,10
ANDHRA PRADESH,2009, MALE VICTIMS,12,12,22,668,777,184,1675
ARUNACHAL PRADESH,2009, MALE VICTIMS,0,0,0,30,28,0,58
ASSAM,2009, MALE VICTIMS,0,0,4,784,398,40,1226
BIHAR,2009, MALE VICTIMS,13,21,51,1419,878,125,2507
CHANDIGARH,2009, MALE VICTIMS,1,0,0,11,6,1,19
CHHATTISGARH,2009, MALE VICTIMS,24,9,27,231,349,117,757
DADRA & NAGAR HAVELI,2009, MALE VICTIMS,1,0,0,1,1,1,4
DAMAN & DIU,2009, MALE VICTIMS,0,0,0,1,3,0,4
DELHI,2009, MALE VICTIMS,17,17,28,243,117,23,445
GOA,2009, MALE VICTIMS,2,0,0,8,13,3,26
GUJARAT,2009, MALE VICTIMS,24,9,4,266,375,56,734
HARYANA,2009, MALE VICTIMS,2,4,9,331,357,83,786
HIMACHAL PRADESH,2009, MALE VICTIMS,0,1,2,31,46,14,94
JAMMU & KASHMIR,2009, MALE VICTIMS,1,0,3,98,104,10,216
JHARKHAND,2009, MALE VICTIMS,3,1,5,609,736,81,1435
KARNATAKA,2009, MALE VICTIMS,12,14,5,363,558,121,1073
KERALA,2009, MALE VICTIMS,25,7,1,60,109,58,260
MADHYA PRADESH,2009, MALE VICTIMS,42,20,25,672,761,257,1777
MAHARASHTRA,2009, MALE VICTIMS,63,11,20,681,721,216,1712
MANIPUR,2009, MALE VICTIMS,2,1,3,56,78,16,156
MEGHALAYA,2009, MALE VICTIMS,0,2,3,69,25,7,106
MIZORAM,2009, MALE VICTIMS,0,0,0,8,20,0,28
NAGALAND,2009, MALE VICTIMS,0,0,0,21,18,1,40
ODISHA,2009, MALE VICTIMS,1,0,8,336,343,118,806
PUDUCHERRY,2009, MALE VICTIMS,0,0,0,13,14,2,29
PUNJAB,2009, MALE VICTIMS,18,15,20,251,312,42,658
RAJASTHAN,2009, MALE VICTIMS,16,16,36,424,473,124,1089
SIKKIM,2009, MALE VICTIMS,2,0,0,7,4,1,14
TAMIL NADU,2009, MALE VICTIMS,36,8,5,364,611,246,1270
TRIPURA,2009, MALE VICTIMS,6,2,0,34,42,7,91
UTTAR PRADESH,2009, MALE VICTIMS,33,89,85,1816,1347,354,3724
UTTARAKHAND,2009, MALE VICTIMS,1,1,1,72,56,13,144
WEST BENGAL,2009, MALE VICTIMS,3,3,6,708,660,88,1468
ANDAMAN & NICOBAR ISLANDS,2010, FEMALE VICTIMS,0,0,2,0,3,0,5
ANDHRA PRADESH,2010, FEMALE VICTIMS,15,12,6,235,213,143,624
ARUNACHAL PRADESH,2010, FEMALE VICTIMS,0,0,0,2,0,0,2
ASSAM,2010, FEMALE VICTIMS,0,0,0,51,35,0,86
BIHAR,2010, FEMALE VICTIMS,10,14,50,370,187,31,662
CHANDIGARH,2010, FEMALE VICTIMS,0,0,0,1,0,1,2
CHHATTISGARH,2010, FEMALE VICTIMS,13,5,19,127,153,40,357
DADRA & NAGAR HAVELI,2010, FEMALE VICTIMS,0,0,0,1,0,0,1
DELHI,2010, FEMALE VICTIMS,4,3,4,55,39,14,119
GOA,2010, FEMALE VICTIMS,0,0,1,5,1,0,7
GUJARAT,2010, FEMALE VICTIMS,19,4,0,131,93,21,268
HARYANA,2010, FEMALE VICTIMS,2,4,6,99,88,14,213
HIMACHAL PRADESH,2010, FEMALE VICTIMS,3,0,0,11,12,2,28
JAMMU & KASHMIR,2010, FEMALE VICTIMS,1,0,0,15,11,3,30
JHARKHAND,2010, FEMALE VICTIMS,0,0,1,141,102,12,256
KARNATAKA,2010, FEMALE VICTIMS,27,3,5,377,262,57,731
KERALA,2010, FEMALE VICTIMS,16,6,0,24,53,27,126
MADHYA PRADESH,2010, FEMALE VICTIMS,21,13,9,246,202,60,551
MAHARASHTRA,2010, FEMALE VICTIMS,78,16,14,552,303,84,1047
MANIPUR,2010, FEMALE VICTIMS,0,0,0,5,13,1,19
MEGHALAYA,2010, FEMALE VICTIMS,1,0,0,5,3,2,11
MIZORAM,2010, FEMALE VICTIMS,0,0,1,0,6,1,8
NAGALAND,2010, FEMALE VICTIMS,0,0,0,1,1,3,5
ODISHA,2010, FEMALE VICTIMS,5,0,1,262,236,32,536
PUDUCHERRY,2010, FEMALE VICTIMS,0,0,0,3,1,0,4
PUNJAB,2010, FEMALE VICTIMS,11,6,6,107,91,21,242
RAJASTHAN,2010, FEMALE VICTIMS,14,8,9,130,113,32,306
SIKKIM,2010, FEMALE VICTIMS,1,1,0,3,3,0,8
TAMIL NADU,2010, FEMALE VICTIMS,38,5,9,236,241,100,629
TRIPURA,2010, FEMALE VICTIMS,0,1,0,24,30,8,63
UTTAR PRADESH,2010, FEMALE VICTIMS,62,30,47,421,243,56,859
UTTARAKHAND,2010, FEMALE VICTIMS,0,0,2,25,11,6,44
WEST BENGAL,2010, FEMALE VICTIMS,2,3,2,542,308,36,893
ANDAMAN & NICOBAR ISLANDS,2010, MALE VICTIMS,0,0,0,2,3,0,5
ANDHRA PRADESH,2010, MALE VICTIMS,7,16,13,962,591,325,1914
ARUNACHAL PRADESH,2010, MALE VICTIMS,0,0,0,53,20,0,73
ASSAM,2010, MALE VICTIMS,0,0,10,712,369,46,1137
BIHAR,2010, MALE VICTIMS,16,30,82,1491,887,194,2700
CHANDIGARH,2010, MALE VICTIMS,1,0,0,5,11,3,20
CHHATTISGARH,2010, MALE VICTIMS,19,8,31,231,314,105,708
DADRA & NAGAR HAVELI,2010, MALE VICTIMS,0,0,0,0,5,0,5
DAMAN & DIU,2010, MALE VICTIMS,0,0,0,4,1,0,5
DELHI,2010, MALE VICTIMS,6,8,14,238,167,25,458
GOA,2010, MALE VICTIMS,0,0,0,9,17,2,28
GUJARAT,2010, MALE VICTIMS,27,14,7,312,365,89,814
HARYANA,2010, MALE VICTIMS,4,6,8,367,381,65,831
HIMACHAL PRADESH,2010, MALE VICTIMS,2,0,3,31,52,17,105
JAMMU & KASHMIR,2010, MALE VICTIMS,0,0,0,91,95,19,205
JHARKHAND,2010, MALE VICTIMS,4,2,1,895,529,65,1496
KARNATAKA,2010, MALE VICTIMS,18,3,4,481,511,130,1147
KERALA,2010, MALE VICTIMS,23,3,1,60,137,55,279
MADHYA PRADESH,2010, MALE VICTIMS,34,27,40,732,813,244,1890
MAHARASHTRA,2010, MALE VICTIMS,91,18,20,670,753,238,1790
MANIPUR,2010, MALE VICTIMS,0,2,0,26,46,8,82
MEGHALAYA,2010, MALE VICTIMS,0,0,1,64,53,8,126
MIZORAM,2010, MALE VICTIMS,0,0,1,8,23,8,40
NAGALAND,2010, MALE VICTIMS,0,0,0,19,16,7,42
ODISHA,2010, MALE VICTIMS,5,0,1,304,401,72,783
PUDUCHERRY,2010, MALE VICTIMS,0,0,0,10,12,8,30
PUNJAB,2010, MALE VICTIMS,10,3,12,277,336,65,703
RAJASTHAN,2010, MALE VICTIMS,15,14,33,437,513,103,1115
SIKKIM,2010, MALE VICTIMS,1,0,0,1,4,3,9
TAMIL NADU,2010, MALE VICTIMS,25,8,7,414,598,227,1279
TRIPURA,2010, MALE VICTIMS,0,1,0,36,43,16,96
UTTAR PRADESH,2010, MALE VICTIMS,76,52,79,1937,1165,288,3597
UTTARAKHAND,2010, MALE VICTIMS,0,1,0,66,52,13,132
WEST BENGAL,2010, MALE VICTIMS,0,5,4,635,794,84,1522
ANDAMAN & NICOBAR ISLANDS,2011, FEMALE VICTIMS,0,0,0,3,2,1,6
ANDHRA PRADESH,2011, FEMALE VICTIMS,26,16,10,415,352,67,886
ARUNACHAL PRADESH,2011, FEMALE VICTIMS,0,0,0,3,0,0,3
ASSAM,2011, FEMALE VICTIMS,0,0,0,51,37,0,88
BIHAR,2011, FEMALE VICTIMS,4,0,15,237,120,14,390
CHANDIGARH,2011, FEMALE VICTIMS,2,0,0,3,0,1,6
CHHATTISGARH,2011, FEMALE VICTIMS,3,4,3,100,129,71,310
DADRA & NAGAR HAVELI,2011, FEMALE VICTIMS,0,0,0,2,2,0,4
DAMAN & DIU,2011, FEMALE VICTIMS,0,0,0,1,0,0,1
DELHI,2011, FEMALE VICTIMS,10,3,5,71,25,13,127
GOA,2011, FEMALE VICTIMS,2,0,0,6,4,4,16
GUJARAT,2011, FEMALE VICTIMS,33,5,5,117,126,28,314
HARYANA,2011, FEMALE VICTIMS,14,8,9,84,45,7,167
HIMACHAL PRADESH,2011, FEMALE VICTIMS,2,1,1,15,14,2,35
JAMMU & KASHMIR,2011, FEMALE VICTIMS,0,0,0,26,12,2,40
JHARKHAND,2011, FEMALE VICTIMS,2,1,5,87,115,27,237
KARNATAKA,2011, FEMALE VICTIMS,17,4,6,289,148,41,505
KERALA,2011, FEMALE VICTIMS,22,1,4,34,52,28,141
MADHYA PRADESH,2011, FEMALE VICTIMS,33,7,11,253,183,64,551
MAHARASHTRA,2011, FEMALE VICTIMS,73,15,19,521,297,89,1014
MANIPUR,2011, FEMALE VICTIMS,0,0,2,8,8,2,20
MEGHALAYA,2011, FEMALE VICTIMS,2,0,0,3,2,0,7
MIZORAM,2011, FEMALE VICTIMS,0,1,1,11,5,0,18
NAGALAND,2011, FEMALE VICTIMS,1,0,1,9,3,0,14
ODISHA,2011, FEMALE VICTIMS,2,2,4,242,116,6,372
PUDUCHERRY,2011, FEMALE VICTIMS,1,0,0,4,3,2,10
PUNJAB,2011, FEMALE VICTIMS,3,5,4,120,75,18,225
RAJASTHAN,2011, FEMALE VICTIMS,10,12,6,143,123,25,319
SIKKIM,2011, FEMALE VICTIMS,0,1,0,2,0,0,3
TAMIL NADU,2011, FEMALE VICTIMS,31,8,3,261,215,86,604
TRIPURA,2011, FEMALE VICTIMS,3,0,2,19,18,8,50
UTTAR PRADESH,2011, FEMALE VICTIMS,24,63,74,382,288,68,899
UTTARAKHAND,2011, FEMALE VICTIMS,2,3,0,53,12,7,77
WEST BENGAL,2011, FEMALE VICTIMS,7,0,3,441,175,21,647
ANDAMAN & NICOBAR ISLANDS,2011, MALE VICTIMS,0,0,0,3,4,2,9
ANDHRA PRADESH,2011, MALE VICTIMS,19,8,29,874,828,206,1964
ARUNACHAL PRADESH,2011, MALE VICTIMS,0,0,0,41,23,1,65
ASSAM,2011, MALE VICTIMS,0,1,1,766,421,97,1286
BIHAR,2011, MALE VICTIMS,12,23,41,1451,1012,152,2691
CHANDIGARH,2011, MALE VICTIMS,0,0,0,7,7,0,14
CHHATTISGARH,2011, MALE VICTIMS,10,11,14,281,315,156,787
DADRA & NAGAR HAVELI,2011, MALE VICTIMS,1,0,0,1,4,0,6
DAMAN & DIU,2011, MALE VICTIMS,1,1,0,3,2,4,11
DELHI,2011, MALE VICTIMS,14,5,20,205,112,28,384
GOA,2011, MALE VICTIMS,0,0,0,3,11,4,18
GUJARAT,2011, MALE VICTIMS,38,10,13,289,451,99,900
HARYANA,2011, MALE VICTIMS,19,20,29,332,322,53,775
HIMACHAL PRADESH,2011, MALE VICTIMS,3,2,1,31,46,14,97
JAMMU & KASHMIR,2011, MALE VICTIMS,0,0,0,170,140,16,326
JHARKHAND,2011, MALE VICTIMS,0,12,5,550,711,102,1380
KARNATAKA,2011, MALE VICTIMS,15,5,6,381,541,133,1081
KERALA,2011, MALE VICTIMS,17,8,1,54,115,57,252
MADHYA PRADESH,2011, MALE VICTIMS,48,27,34,697,741,217,1764
MAHARASHTRA,2011, MALE VICTIMS,92,24,27,654,723,259,1779
MANIPUR,2011, MALE VICTIMS,1,1,4,140,121,8,275
MEGHALAYA,2011, MALE VICTIMS,0,3,7,36,52,9,107
MIZORAM,2011, MALE VICTIMS,0,0,1,15,7,2,25
NAGALAND,2011, MALE VICTIMS,0,0,1,42,58,3,104
ODISHA,2011, MALE VICTIMS,4,10,11,395,405,38,863
PUDUCHERRY,2011, MALE VICTIMS,1,0,1,17,5,1,25
PUNJAB,2011, MALE VICTIMS,7,8,6,266,247,67,601
RAJASTHAN,2011, MALE VICTIMS,18,17,26,393,483,103,1040
SIKKIM,2011, MALE VICTIMS,0,0,0,3,2,1,6
TAMIL NADU,2011, MALE VICTIMS,18,6,2,346,507,228,1107
TRIPURA,2011, MALE VICTIMS,0,4,2,33,44,17,100
UTTAR PRADESH,2011, MALE VICTIMS,37,97,102,2050,1619,378,4283
UTTARAKHAND,2011, MALE VICTIMS,3,1,5,111,53,18,191
WEST BENGAL,2011, MALE VICTIMS,1,2,2,527,417,57,1006
ANDAMAN & NICOBAR ISLANDS,2012, FEMALE VICTIMS,0,2,0,0,0,0,2
ANDHRA PRADESH,2012, FEMALE VICTIMS,25,7,9,411,296,82,830
ARUNACHAL PRADESH,2012, FEMALE VICTIMS,0,0,0,0,1,0,1
ASSAM,2012, FEMALE VICTIMS,0,0,0,61,42,0,103
BIHAR,2012, FEMALE VICTIMS,12,8,12,436,151,18,637
CHANDIGARH,2012, FEMALE VICTIMS,0,0,0,3,2,1,6
CHHATTISGARH,2012, FEMALE VICTIMS,10,7,27,129,150,40,363
DADRA & NAGAR HAVELI,2012, FEMALE VICTIMS,0,1,0,0,2,1,4
DAMAN & DIU,2012, FEMALE VICTIMS,0,0,0,0,0,0,0
DELHI,2012, FEMALE VICTIMS,4,1,2,63,39,7,116
GOA,2012, FEMALE VICTIMS,2,1,0,8,4,5,20
GUJARAT,2012, FEMALE VICTIMS,24,3,2,137,145,29,340
HARYANA,2012, FEMALE VICTIMS,3,5,5,97,63,12,185
HIMACHAL PRADESH,2012, FEMALE VICTIMS,1,2,3,10,16,4,36
JAMMU & KASHMIR,2012, FEMALE VICTIMS,0,0,0,13,15,2,30
JHARKHAND,2012, FEMALE VICTIMS,2,0,1,115,123,25,266
KARNATAKA,2012, FEMALE VICTIMS,49,17,14,272,229,43,624
KERALA,2012, FEMALE VICTIMS,25,5,0,24,51,23,128
LAKSHADWEEP,2012, FEMALE VICTIMS,0,0,0,0,1,0,1
MADHYA PRADESH,2012, FEMALE VICTIMS,11,13,6,235,187,64,516
MAHARASHTRA,2012, FEMALE VICTIMS,62,11,21,541,341,73,1049
MANIPUR,2012, FEMALE VICTIMS,2,0,0,9,8,0,19
MEGHALAYA,2012, FEMALE VICTIMS,0,0,0,11,4,0,15
MIZORAM,2012, FEMALE VICTIMS,0,0,0,1,1,0,2
NAGALAND,2012, FEMALE VICTIMS,0,0,0,5,1,0,6
ODISHA,2012, FEMALE VICTIMS,2,2,0,257,237,47,545
PUDUCHERRY,2012, FEMALE VICTIMS,0,0,0,5,1,2,8
PUNJAB,2012, FEMALE VICTIMS,3,5,7,120,67,17,219
RAJASTHAN,2012, FEMALE VICTIMS,8,6,12,129,102,30,287
SIKKIM,2012, FEMALE VICTIMS,0,0,0,3,0,0,3
TAMIL NADU,2012, FEMALE VICTIMS,45,3,4,233,246,93,624
TRIPURA,2012, FEMALE VICTIMS,3,2,1,36,17,4,63
UTTAR PRADESH,2012, FEMALE VICTIMS,30,55,73,360,257,65,840
UTTARAKHAND,2012, FEMALE VICTIMS,0,0,0,29,16,3,48
WEST BENGAL,2012, FEMALE VICTIMS,1,0,5,175,53,16,250
ANDAMAN & NICOBAR ISLANDS,2012, MALE VICTIMS,0,0,0,2,2,2,6
ANDHRA PRADESH,2012, MALE VICTIMS,11,14,55,855,776,221,1932
ARUNACHAL PRADESH,2012, MALE VICTIMS,0,0,0,40,29,2,71
ASSAM,2012, MALE VICTIMS,0,1,0,790,477,55,1323
BIHAR,2012, MALE VICTIMS,25,11,48,1401,921,96,2502
CHANDIGARH,2012, MALE VICTIMS,0,0,0,7,3,1,11
CHHATTISGARH,2012, MALE VICTIMS,13,12,29,282,358,112,806
DADRA & NAGAR HAVELI,2012, MALE VICTIMS,0,0,0,0,3,2,5
DAMAN & DIU,2012, MALE VICTIMS,0,0,0,0,2,0,2
DELHI,2012, MALE VICTIMS,21,8,15,139,254,36,473
GOA,2012, MALE VICTIMS,0,0,0,10,17,6,33
GUJARAT,2012, MALE VICTIMS,23,6,8,312,378,78,805
HARYANA,2012, MALE VICTIMS,4,6,8,307,360,100,785
HIMACHAL PRADESH,2012, MALE VICTIMS,3,1,4,27,49,10,94
JAMMU & KASHMIR,2012, MALE VICTIMS,0,0,0,94,126,16,236
JHARKHAND,2012, MALE VICTIMS,2,0,6,726,624,73,1431
KARNATAKA,2012, MALE VICTIMS,58,11,18,428,532,129,1176
KERALA,2012, MALE VICTIMS,14,5,0,62,116,54,251
MADHYA PRADESH,2012, MALE VICTIMS,11,55,11,695,815,248,1835
MAHARASHTRA,2012, MALE VICTIMS,54,32,20,700,859,262,1927
MANIPUR,2012, MALE VICTIMS,3,4,3,132,95,12,249
MEGHALAYA,2012, MALE VICTIMS,0,0,0,54,48,9,111
MIZORAM,2012, MALE VICTIMS,0,0,0,23,10,0,33
NAGALAND,2012, MALE VICTIMS,0,0,0,81,57,3,141
ODISHA,2012, MALE VICTIMS,4,2,3,276,369,51,705
PUDUCHERRY,2012, MALE VICTIMS,1,0,0,12,11,3,27
PUNJAB,2012, MALE VICTIMS,7,4,6,266,247,66,596
RAJASTHAN,2012, MALE VICTIMS,13,18,36,398,467,101,1033
SIKKIM,2012, MALE VICTIMS,0,0,2,1,3,0,6
TAMIL NADU,2012, MALE VICTIMS,43,5,0,364,554,234,1200
TRIPURA,2012, MALE VICTIMS,4,7,3,21,55,13,103
UTTAR PRADESH,2012, MALE VICTIMS,30,69,119,1927,1383,331,3859
UTTARAKHAND,2012, MALE VICTIMS,1,0,2,139,46,25,213
WEST BENGAL,2012, MALE VICTIMS,1,5,9,735,662,149,1561
ANDAMAN & NICOBAR ISLANDS,2013, FEMALE VICTIMS,1,0,0,3,4,0,8
ANDHRA PRADESH,2013, FEMALE VICTIMS,18,6,7,379,299,91,800
ARUNACHAL PRADESH,2013, FEMALE VICTIMS,0,0,0,1,0,0,1
ASSAM,2013, FEMALE VICTIMS,0,0,0,62,35,0,97
BIHAR,2013, FEMALE VICTIMS,9,5,27,439,174,18,672
CHANDIGARH,2013, FEMALE VICTIMS,0,0,0,1,2,0,3
CHHATTISGARH,2013, FEMALE VICTIMS,15,2,7,124,134,44,326
DADRA & NAGAR HAVELI,2013, FEMALE VICTIMS,0,0,0,3,3,0,6
DAMAN & DIU,2013, FEMALE VICTIMS,0,0,0,1,0,0,1
DELHI,2013, FEMALE VICTIMS,13,4,2,48,41,18,126
GOA,2013, FEMALE VICTIMS,1,0,1,14,12,3,31
GUJARAT,2013, FEMALE VICTIMS,34,6,2,120,129,34,325
HARYANA,2013, FEMALE VICTIMS,0,2,2,96,106,15,221
HIMACHAL PRADESH,2013, FEMALE VICTIMS,4,1,1,10,14,9,39
JAMMU & KASHMIR,2013, FEMALE VICTIMS,0,0,0,26,16,4,46
JHARKHAND,2013, FEMALE VICTIMS,1,1,0,119,72,8,201
KARNATAKA,2013, FEMALE VICTIMS,16,9,7,335,246,66,679
KERALA,2013, FEMALE VICTIMS,17,4,5,20,45,18,109
MADHYA PRADESH,2013, FEMALE VICTIMS,18,11,11,277,231,77,625
MAHARASHTRA,2013, FEMALE VICTIMS,79,15,18,490,294,104,1000
MANIPUR,2013, FEMALE VICTIMS,2,1,1,5,7,2,18
MEGHALAYA,2013, FEMALE VICTIMS,0,0,3,16,2,1,22
MIZORAM,2013, FEMALE VICTIMS,0,0,0,3,0,0,3
NAGALAND,2013, FEMALE VICTIMS,0,0,0,9,0,0,9
ODISHA,2013, FEMALE VICTIMS,3,1,0,215,201,40,460
PUDUCHERRY,2013, FEMALE VICTIMS,1,0,0,3,5,1,10
PUNJAB,2013, FEMALE VICTIMS,15,6,8,92,68,14,203
RAJASTHAN,2013, FEMALE VICTIMS,13,8,8,150,114,35,328
SIKKIM,2013, FEMALE VICTIMS,1,0,0,3,2,0,6
TAMIL NADU,2013, FEMALE VICTIMS,45,6,5,214,224,93,587
TRIPURA,2013, FEMALE VICTIMS,4,3,3,22,21,4,57
UTTAR PRADESH,2013, FEMALE VICTIMS,38,56,71,443,266,81,955
UTTARAKHAND,2013, FEMALE VICTIMS,1,1,0,38,10,1,51
WEST BENGAL,2013, FEMALE VICTIMS,2,5,4,409,248,25,693
ANDAMAN & NICOBAR ISLANDS,2013, MALE VICTIMS,2,0,0,3,5,0,10
ANDHRA PRADESH,2013, MALE VICTIMS,12,12,22,668,777,184,1675
ARUNACHAL PRADESH,2013, MALE VICTIMS,0,0,0,30,28,0,58
ASSAM,2013, MALE VICTIMS,0,0,4,784,398,40,1226
BIHAR,2013, MALE VICTIMS,13,21,51,1419,878,125,2507
CHANDIGARH,2013, MALE VICTIMS,1,0,0,11,6,1,19
CHHATTISGARH,2013, MALE VICTIMS,24,9,27,231,349,117,757
DADRA & NAGAR HAVELI,2013, MALE VICTIMS,1,0,0,1,1,1,4
DAMAN & DIU,2013, MALE VICTIMS,0,0,0,1,3,0,4
DELHI,2013, MALE VICTIMS,17,17,28,243,117,23,445
GOA,2013, MALE VICTIMS,2,0,0,8,13,3,26
GUJARAT,2013, MALE VICTIMS,24,9,4,266,375,56,734
HARYANA,2013, MALE VICTIMS,2,4,9,331,357,83,786
HIMACHAL PRADESH,2013, MALE VICTIMS,0,1,2,31,46,14,94
JAMMU & KASHMIR,2013, MALE VICTIMS,1,0,3,98,104,10,216
JHARKHAND,2013, MALE VICTIMS,3,1,5,609,736,81,1435
KARNATAKA,2013, MALE VICTIMS,12,14,5,363,558,121,1073
KERALA,2013, MALE VICTIMS,25,7,1,60,109,58,260
MADHYA PRADESH,2013, MALE VICTIMS,42,20,25,672,761,257,1777
MAHARASHTRA,2013, MALE VICTIMS,63,11,20,681,721,216,1712
MANIPUR,2013, MALE VICTIMS,2,1,3,56,78,16,156
MEGHALAYA,2013, MALE VICTIMS,0,2,3,69,25,7,106
MIZORAM,2013, MALE VICTIMS,0,0,0,8,20,0,28
NAGALAND,2013, MALE VICTIMS,0,0,0,21,18,1,40
ODISHA,2013, MALE VICTIMS,1,0,8,336,343,118,806
PUDUCHERRY,2013, MALE VICTIMS,0,0,0,13,14,2,29
PUNJAB,2013, MALE VICTIMS,18,15,20,251,312,42,658
RAJASTHAN,2013, MALE VICTIMS,16,16,36,424,473,124,1089
SIKKIM,2013, MALE VICTIMS,2,0,0,7,4,1,14
TAMIL NADU,2013, MALE VICTIMS,36,8,5,364,611,246,1270
TRIPURA,2013, MALE VICTIMS,6,2,0,34,42,7,91
UTTAR PRADESH,2013, MALE VICTIMS,33,89,85,1816,1347,354,3724
UTTARAKHAND,2013, MALE VICTIMS,1,1,1,72,56,13,144
WEST BENGAL,2013, MALE VICTIMS,3,3,6,708,660,88,1468
ANDAMAN & NICOBAR ISLANDS,2014, FEMALE VICTIMS,0,0,2,0,3,0,5
ANDHRA PRADESH,2014, FEMALE VICTIMS,15,12,6,235,213,143,624
ARUNACHAL PRADESH,2014, FEMALE VICTIMS,0,0,0,2,0,0,2
ASSAM,2014, FEMALE VICTIMS,0,0,0,51,35,0,86
BIHAR,2014, FEMALE VICTIMS,10,14,50,370,187,31,662
CHANDIGARH,2014, FEMALE VICTIMS,0,0,0,1,0,1,2
CHHATTISGARH,2014, FEMALE VICTIMS,13,5,19,127,153,40,357
DADRA & NAGAR HAVELI,2014, FEMALE VICTIMS,0,0,0,1,0,0,1
DELHI,2014, FEMALE VICTIMS,4,3,4,55,39,14,119
GOA,2014, FEMALE VICTIMS,0,0,1,5,1,0,7
GUJARAT,2014, FEMALE VICTIMS,19,4,0,131,93,21,268
HARYANA,2014, FEMALE VICTIMS,2,4,6,99,88,14,213
HIMACHAL PRADESH,2014, FEMALE VICTIMS,3,0,0,11,12,2,28
JAMMU & KASHMIR,2014, FEMALE VICTIMS,1,0,0,15,11,3,30
JHARKHAND,2014, FEMALE VICTIMS,0,0,1,141,102,12,256
KARNATAKA,2014, FEMALE VICTIMS,27,3,5,377,262,57,731
KERALA,2014, FEMALE VICTIMS,16,6,0,24,53,27,126
MADHYA PRADESH,2014, FEMALE VICTIMS,21,13,9,246,202,60,551
MAHARASHTRA,2014, FEMALE VICTIMS,78,16,14,552,303,84,1047
MANIPUR,2014, FEMALE VICTIMS,0,0,0,5,13,1,19
MEGHALAYA,2014, FEMALE VICTIMS,1,0,0,5,3,2,11
MIZORAM,2014, FEMALE VICTIMS,0,0,1,0,6,1,8
NAGALAND,2014, FEMALE VICTIMS,0,0,0,1,1,3,5
ODISHA,2014, FEMALE VICTIMS,5,0,1,262,236,32,536
PUDUCHERRY,2014, FEMALE VICTIMS,0,0,0,3,1,0,4
PUNJAB,2014, FEMALE VICTIMS,11,6,6,107,91,21,242
RAJASTHAN,2014, FEMALE VICTIMS,14,8,9,130,113,32,306
SIKKIM,2014, FEMALE VICTIMS,1,1,0,3,3,0,8
TAMIL NADU,2014, FEMALE VICTIMS,38,5,9,236,241,100,629
TRIPURA,2014, FEMALE VICTIMS,0,1,0,24,30,8,63
UTTAR PRADESH,2014, FEMALE VICTIMS,62,30,47,421,243,56,859
UTTARAKHAND,2014, FEMALE VICTIMS,0,0,2,25,11,6,44
WEST BENGAL,2014, FEMALE VICTIMS,2,3,2,542,308,36,893
ANDAMAN & NICOBAR ISLANDS,2014, MALE VICTIMS,0,0,0,2,3,0,5
ANDHRA PRADESH,2014, MALE VICTIMS,7,16,13,962,591,325,1914
ARUNACHAL PRADESH,2014, MALE VICTIMS,0,0,0,53,20,0,73
ASSAM,2014, MALE VICTIMS,0,0,10,712,369,46,1137
BIHAR,2014, MALE VICTIMS,16,30,82,1491,887,194,2700
CHANDIGARH,2014, MALE VICTIMS,1,0,0,5,11,3,20
CHHATTISGARH,2014, MALE VICTIMS,19,8,31,231,314,105,708
DADRA & NAGAR HAVELI,2014, MALE VICTIMS,0,0,0,0,5,0,5
DAMAN & DIU,2014, MALE VICTIMS,0,0,0,4,1,0,5
DELHI,2014, MALE VICTIMS,6,8,14,238,167,25,458
GOA,2014, MALE VICTIMS,0,0,0,9,17,2,28
GUJARAT,2014, MALE VICTIMS,27,14,7,312,365,89,814
HARYANA,2014, MALE VICTIMS,4,6,8,367,381,65,831
HIMACHAL PRADESH,2014, MALE VICTIMS,2,0,3,31,52,17,105
JAMMU & KASHMIR,2014, MALE VICTIMS,0,0,0,91,95,19,205
JHARKHAND,2014, MALE VICTIMS,4,2,1,895,529,65,1496
KARNATAKA,2014, MALE VICTIMS,18,3,4,481,511,130,1147
KERALA,2014, MALE VICTIMS,23,3,1,60,137,55,279
MADHYA PRADESH,2014, MALE VICTIMS,34,27,40,732,813,244,1890
MAHARASHTRA,2014, MALE VICTIMS,91,18,20,670,753,238,1790
MANIPUR,2014, MALE VICTIMS,0,2,0,26,46,8,82
MEGHALAYA,2014, MALE VICTIMS,0,0,1,64,53,8,126
MIZORAM,2014, MALE VICTIMS,0,0,1,8,23,8,40
NAGALAND,2014, MALE VICTIMS,0,0,0,19,16,7,42
ODISHA,2014, MALE VICTIMS,5,0,1,304,401,72,783
PUDUCHERRY,2014, MALE VICTIMS,0,0,0,10,12,8,30
PUNJAB,2014, MALE VICTIMS,10,3,12,277,336,65,703
RAJASTHAN,2014, MALE VICTIMS,15,14,33,437,513,103,1115
SIKKIM,2014, MALE VICTIMS,1,0,0,1,4,3,9
TAMIL NADU,2014, MALE VICTIMS,25,8,7,414,598,227,1279
TRIPURA,2014, MALE VICTIMS,0,1,0,36,43,16,96
UTTAR PRADESH,2014, MALE VICTIMS,76,52,79,1937,1165,288,3597
UTTARAKHAND,2014, MALE VICTIMS,0,1,0,66,52,13,132
WEST BENGAL,2014, MALE VICTIMS,0,5,4,635,794,84,1522
