AREA_NAME,YEAR,RAPE_CASES_REPORTED,VICTIMS_BETWEEN_10-14_YRS,VICTIMS_BETWEEN_14-18_YRS,VICTIMS_BETWEEN_18-30_YRS,VICTIMS_BETWEEN_30-50_YRS,VICTIMS_ABOVE_50_YRS,VICTIMS_OF_RAPE_TOTAL
ANDAMAN & NICOBAR ISLANDS,2001,3,0,3,0,0,0,3
ANDAMAN & NICOBAR ISLANDS,2001,1,0,1,0,0,0,1
ANDAMAN & NICOBAR ISLANDS,2001,2,0,2,0,0,0,2
ANDHRA PRADESH,2001,871,138,254,328,80,14,814
ANDHRA PRADESH,2001,4,2,0,2,0,0,4
ANDHRA PRADESH,2001,867,136,254,326,80,14,810
ARUNACHAL PRADESH,2001,33,0,1,28,4,0,33
ARUNACHAL PRADESH,2001,0,0,0,0,0,0,0
ARUNACHAL PRADESH,2001,33,0,1,28,4,0,33
ASSAM,2001,817,73,245,370,119,2,809
ASSAM,2001,8,1,7,0,0,0,8
ASSAM,2001,809,72,238,370,119,2,801
BIHAR,2001,888,15,198,562,112,0,887
BIHAR,2001,8,2,5,1,0,0,8
BIHAR,2001,880,13,193,561,112,0,879
CHANDIGARH,2001,18,8,4,4,3,0,19
CHANDIGARH,2001,2,0,0,2,0,0,2
CHANDIGARH,2001,16,8,4,2,3,0,17
CHHATTISGARH,2001,959,191,218,384,137,4,934
CHHATTISGARH,2001,6,3,1,1,1,0,6
CHHATTISGARH,2001,953,188,217,383,136,4,928
DADRA & NAGAR HAVELI,2001,6,0,3,3,0,0,6
DADRA & NAGAR HAVELI,2001,0,0,0,0,0,0,0
DADRA & NAGAR HAVELI,2001,6,0,3,3,0,0,6
DAMAN & DIU,2001,0,0,0,0,0,0,0
DAMAN & DIU,2001,0,0,0,0,0,0,0
DAMAN & DIU,2001,0,0,0,0,0,0,0
DELHI,2001,381,81,154,59,41,0,335
DELHI,2001,9,3,2,1,0,0,6
DELHI,2001,372,78,152,58,41,0,329
GOA,2001,12,7,1,0,1,0,9
GOA,2001,0,0,0,0,0,0,0
GOA,2001,12,7,1,0,1,0,9
GUJARAT,2001,286,23,87,125,36,0,271
GUJARAT,2001,2,0,2,0,0,0,2
GUJARAT,2001,284,23,85,125,36,0,269
HARYANA,2001,398,62,125,134,40,3,364
HARYANA,2001,0,0,0,0,0,0,0
HARYANA,2001,398,62,125,134,40,3,364
HIMACHAL PRADESH,2001,124,15,43,35,9,2,104
HIMACHAL PRADESH,2001,0,0,0,0,0,0,0
HIMACHAL PRADESH,2001,124,15,43,35,9,2,104
JAMMU & KASHMIR,2001,169,24,41,84,20,0,169
JAMMU & KASHMIR,2001,2,0,1,1,0,0,2
JAMMU & KASHMIR,2001,167,24,40,83,20,0,167
JHARKHAND,2001,567,3,4,478,73,0,558
JHARKHAND,2001,12,3,4,2,2,0,11
JHARKHAND,2001,555,0,0,476,71,0,547
KARNATAKA,2001,293,63,62,123,21,0,269
KARNATAKA,2001,5,0,1,1,0,0,2
KARNATAKA,2001,288,63,61,122,21,0,267
KERALA,2001,562,46,126,306,64,1,543
KERALA,2001,4,0,1,1,0,1,3
KERALA,2001,558,46,125,305,64,0,540
LAKSHADWEEP,2001,0,0,0,0,0,0,0
LAKSHADWEEP,2001,0,0,0,0,0,0,0
LAKSHADWEEP,2001,0,0,0,0,0,0,0
MADHYA PRADESH,2001,2851,304,557,1250,627,27,2765
MADHYA PRADESH,2001,301,39,66,130,56,0,291
MADHYA PRADESH,2001,2550,265,491,1120,571,27,2474
MAHARASHTRA,2001,1302,152,419,503,135,4,1213
MAHARASHTRA,2001,20,5,6,4,4,0,19
MAHARASHTRA,2001,1282,147,413,499,131,4,1194
MANIPUR,2001,20,1,4,9,2,1,17
MANIPUR,2001,2,0,0,0,0,0,0
MANIPUR,2001,18,1,4,9,2,1,17
MEGHALAYA,2001,26,2,4,14,3,0,23
MEGHALAYA,2001,5,0,1,1,2,0,4
MEGHALAYA,2001,21,2,3,13,1,0,19
MIZORAM,2001,52,0,30,14,8,0,52
MIZORAM,2001,0,0,0,0,0,0,0
MIZORAM,2001,52,0,30,14,8,0,52
NAGALAND,2001,17,0,8,6,3,0,17
NAGALAND,2001,1,0,0,0,1,0,1
NAGALAND,2001,16,0,8,6,2,0,16
ODISHA,2001,790,9,297,402,74,0,782
ODISHA,2001,4,0,3,1,0,0,4
ODISHA,2001,786,9,294,401,74,0,778
PUDUCHERRY,2001,9,2,2,1,1,0,6
PUDUCHERRY,2001,0,0,0,0,0,0,0
PUDUCHERRY,2001,9,2,2,1,1,0,6
PUNJAB,2001,298,30,137,98,24,1,290
PUNJAB,2001,0,0,0,0,0,0,0
PUNJAB,2001,298,30,137,98,24,1,290
RAJASTHAN,2001,1049,44,229,606,147,7,1033
RAJASTHAN,2001,18,1,7,8,1,0,17
RAJASTHAN,2001,1031,43,222,598,146,7,1016
SIKKIM,2001,8,0,4,2,1,0,7
SIKKIM,2001,1,0,0,0,0,0,0
SIKKIM,2001,7,0,4,2,1,0,7
TAMIL NADU,2001,423,15,174,192,34,2,417
TAMIL NADU,2001,21,2,4,13,2,0,21
TAMIL NADU,2001,402,13,170,179,32,2,396
TRIPURA,2001,102,0,50,47,5,0,102
TRIPURA,2001,0,0,0,0,0,0,0
TRIPURA,2001,102,0,50,47,5,0,102
UTTAR PRADESH,2001,1958,122,406,1082,314,0,1924
UTTAR PRADESH,2001,3,2,0,1,0,0,3
UTTAR PRADESH,2001,1955,120,406,1081,314,0,1921
UTTARAKHAND,2001,74,7,16,38,7,0,68
UTTARAKHAND,2001,0,0,0,0,0,0,0
UTTARAKHAND,2001,74,7,16,38,7,0,68
WEST BENGAL,2001,709,3,5,594,103,0,705
WEST BENGAL,2001,0,0,0,0,0,0,0
WEST BENGAL,2001,709,3,5,594,103,0,705
ANDAMAN & NICOBAR ISLANDS,2002,2,0,1,1,0,0,2
ANDAMAN & NICOBAR ISLANDS,2002,0,0,0,0,0,0,0
ANDAMAN & NICOBAR ISLANDS,2002,2,0,1,1,0,0,2
ANDHRA PRADESH,2002,1002,67,35,709,148,8,967
ANDHRA PRADESH,2002,5,2,0,3,0,0,5
ANDHRA PRADESH,2002,997,65,35,706,148,8,962
ARUNACHAL PRADESH,2002,38,0,3,30,5,0,38
ARUNACHAL PRADESH,2002,0,0,0,0,0,0,0
ARUNACHAL PRADESH,2002,38,0,3,30,5,0,38
ASSAM,2002,970,0,3,621,346,0,970
ASSAM,2002,10,0,0,5,5,0,10
ASSAM,2002,960,0,3,616,341,0,960
BIHAR,2002,1040,2,2,805,231,0,1040
BIHAR,2002,3,0,1,2,0,0,3
BIHAR,2002,1037,2,1,803,231,0,1037
CHANDIGARH,2002,18,4,1,9,3,0,17
CHANDIGARH,2002,2,0,1,1,0,0,2
CHANDIGARH,2002,16,4,0,8,3,0,15
CHHATTISGARH,2002,992,131,25,652,147,11,966
CHHATTISGARH,2002,63,13,18,16,11,3,61
CHHATTISGARH,2002,929,118,7,636,136,8,905
DADRA & NAGAR HAVELI,2002,4,1,1,1,0,0,3
DADRA & NAGAR HAVELI,2002,0,0,0,0,0,0,0
DADRA & NAGAR HAVELI,2002,4,1,1,1,0,0,3
DAMAN & DIU,2002,0,0,0,0,0,0,0
DAMAN & DIU,2002,0,0,0,0,0,0,0
DAMAN & DIU,2002,0,0,0,0,0,0,0
DELHI,2002,403,54,52,217,49,0,372
DELHI,2002,32,6,12,10,0,0,28
DELHI,2002,371,48,40,207,49,0,344
GOA,2002,12,3,3,4,1,0,11
GOA,2002,0,0,0,0,0,0,0
GOA,2002,12,3,3,4,1,0,11
GUJARAT,2002,267,16,43,176,17,0,252
GUJARAT,2002,10,4,2,2,0,0,8
GUJARAT,2002,257,12,41,174,17,0,244
HARYANA,2002,361,49,6,237,39,1,332
HARYANA,2002,52,6,3,39,4,0,52
HARYANA,2002,309,43,3,198,35,1,280
HIMACHAL PRADESH,2002,137,5,16,71,36,4,132
HIMACHAL PRADESH,2002,1,1,0,0,0,0,1
HIMACHAL PRADESH,2002,136,4,16,71,36,4,131
JAMMU & KASHMIR,2002,192,0,7,140,44,1,192
JAMMU & KASHMIR,2002,3,0,0,3,0,0,3
JAMMU & KASHMIR,2002,189,0,7,137,44,1,189
JHARKHAND,2002,797,0,43,676,78,0,797
JHARKHAND,2002,18,0,4,11,3,0,18
JHARKHAND,2002,779,0,39,665,75,0,779
KARNATAKA,2002,292,10,6,218,54,1,289
KARNATAKA,2002,4,1,0,3,0,0,4
KARNATAKA,2002,288,9,6,215,54,1,285
KERALA,2002,499,29,132,265,45,3,474
KERALA,2002,4,1,0,3,0,0,4
KERALA,2002,495,28,132,262,45,3,470
LAKSHADWEEP,2002,1,0,0,0,1,0,1
LAKSHADWEEP,2002,0,0,0,0,0,0,0
LAKSHADWEEP,2002,1,0,0,0,1,0,1
MADHYA PRADESH,2002,2891,185,252,1549,811,14,2811
MADHYA PRADESH,2002,72,11,16,37,4,1,69
MADHYA PRADESH,2002,2819,174,236,1512,807,13,2742
MAHARASHTRA,2002,1352,130,319,693,140,7,1289
MAHARASHTRA,2002,21,3,5,9,4,0,21
MAHARASHTRA,2002,1331,127,314,684,136,7,1268
MANIPUR,2002,14,0,0,14,0,0,14
MANIPUR,2002,3,0,0,3,0,0,3
MANIPUR,2002,11,0,0,11,0,0,11
MEGHALAYA,2002,38,9,22,4,0,0,35
MEGHALAYA,2002,1,0,0,0,0,0,0
MEGHALAYA,2002,37,9,22,4,0,0,35
MIZORAM,2002,76,1,1,52,13,9,76
MIZORAM,2002,0,0,0,0,0,0,0
MIZORAM,2002,76,1,1,52,13,9,76
NAGALAND,2002,17,1,3,11,0,0,15
NAGALAND,2002,0,0,0,0,0,0,0
NAGALAND,2002,17,1,3,11,0,0,15
ODISHA,2002,691,9,0,614,56,0,679
ODISHA,2002,1,1,0,0,0,0,1
ODISHA,2002,690,8,0,614,56,0,678
PUDUCHERRY,2002,6,0,3,2,0,0,5
PUDUCHERRY,2002,0,0,0,0,0,0,0
PUDUCHERRY,2002,6,0,3,2,0,0,5
PUNJAB,2002,299,12,32,213,33,1,291
PUNJAB,2002,4,0,2,2,0,0,4
PUNJAB,2002,295,12,30,211,33,1,287
RAJASTHAN,2002,1051,8,25,788,220,5,1046
RAJASTHAN,2002,31,3,9,13,5,1,31
RAJASTHAN,2002,1020,5,16,775,215,4,1015
SIKKIM,2002,6,2,2,2,0,0,6
SIKKIM,2002,1,1,0,0,0,0,1
SIKKIM,2002,5,1,2,2,0,0,5
TAMIL NADU,2002,534,8,6,465,39,1,519
TAMIL NADU,2002,0,0,0,0,0,0,0
TAMIL NADU,2002,534,8,6,465,39,1,519
TRIPURA,2002,108,0,0,98,10,0,108
TRIPURA,2002,0,0,0,0,0,0,0
TRIPURA,2002,108,0,0,98,10,0,108
UTTAR PRADESH,2002,1415,111,271,775,220,0,1377
UTTAR PRADESH,2002,12,1,2,8,0,0,11
UTTAR PRADESH,2002,1403,110,269,767,220,0,1366
UTTARAKHAND,2002,89,4,2,66,15,0,87
UTTARAKHAND,2002,16,4,2,6,2,0,14
UTTARAKHAND,2002,73,0,0,60,13,0,73
WEST BENGAL,2002,759,3,8,552,191,0,754
WEST BENGAL,2002,0,0,0,0,0,0,0
WEST BENGAL,2002,759,3,8,552,191,0,754
ANDAMAN & NICOBAR ISLANDS,2003,2,0,1,0,0,0,1
ANDAMAN & NICOBAR ISLANDS,2003,0,0,0,0,0,0,0
ANDAMAN & NICOBAR ISLANDS,2003,2,0,1,0,0,0,1
ANDHRA PRADESH,2003,946,135,215,429,127,7,913
ANDHRA PRADESH,2003,15,2,1,7,2,0,12
ANDHRA PRADESH,2003,931,133,214,422,125,7,901
ARUNACHAL PRADESH,2003,31,5,4,19,0,0,28
ARUNACHAL PRADESH,2003,0,0,0,0,0,0,0
ARUNACHAL PRADESH,2003,31,5,4,19,0,0,28
ASSAM,2003,1095,5,0,827,260,3,1095
ASSAM,2003,19,0,0,19,0,0,19
ASSAM,2003,1076,5,0,808,260,3,1076
BIHAR,2003,985,1,1,686,296,0,984
BIHAR,2003,1,0,1,0,0,0,1
BIHAR,2003,984,1,0,686,296,0,983
CHANDIGARH,2003,18,1,5,7,2,0,15
CHANDIGARH,2003,1,0,0,0,0,0,0
CHANDIGARH,2003,17,1,5,7,2,0,15
CHHATTISGARH,2003,898,97,62,376,331,5,871
CHHATTISGARH,2003,39,2,16,13,7,0,38
CHHATTISGARH,2003,859,95,46,363,324,5,833
DADRA & NAGAR HAVELI,2003,1,0,0,1,0,0,1
DADRA & NAGAR HAVELI,2003,0,0,0,0,0,0,0
DADRA & NAGAR HAVELI,2003,1,0,0,1,0,0,1
DAMAN & DIU,2003,5,0,3,0,0,0,3
DAMAN & DIU,2003,0,0,0,0,0,0,0
DAMAN & DIU,2003,5,0,3,0,0,0,3
DELHI,2003,490,50,76,321,17,0,464
DELHI,2003,21,5,11,4,0,0,20
DELHI,2003,469,45,65,317,17,0,444
GOA,2003,31,9,8,7,2,0,26
GOA,2003,0,0,0,0,0,0,0
GOA,2003,31,9,8,7,2,0,26
GUJARAT,2003,236,17,46,143,13,0,219
GUJARAT,2003,7,0,3,3,0,0,6
GUJARAT,2003,229,17,43,140,13,0,213
HARYANA,2003,353,5,70,248,28,0,351
HARYANA,2003,14,0,3,11,0,0,14
HARYANA,2003,339,5,67,237,28,0,337
HIMACHAL PRADESH,2003,126,14,25,56,23,0,118
HIMACHAL PRADESH,2003,2,0,1,1,0,0,2
HIMACHAL PRADESH,2003,124,14,24,55,23,0,116
JAMMU & KASHMIR,2003,211,1,0,147,62,0,210
JAMMU & KASHMIR,2003,2,0,0,2,0,0,2
JAMMU & KASHMIR,2003,209,1,0,145,62,0,208
JHARKHAND,2003,712,6,10,606,90,0,712
JHARKHAND,2003,14,2,6,6,0,0,14
JHARKHAND,2003,698,4,4,600,90,0,698
KARNATAKA,2003,321,47,67,135,38,16,303
KARNATAKA,2003,1,0,0,0,0,0,0
KARNATAKA,2003,320,47,67,135,38,16,303
KERALA,2003,394,36,13,267,56,2,374
KERALA,2003,7,3,0,3,0,0,6
KERALA,2003,387,33,13,264,56,2,368
LAKSHADWEEP,2003,2,0,0,2,0,0,2
LAKSHADWEEP,2003,0,0,0,0,0,0,0
LAKSHADWEEP,2003,2,0,0,2,0,0,2
MADHYA PRADESH,2003,2738,231,405,1546,486,7,2675
MADHYA PRADESH,2003,123,10,23,71,16,0,120
MADHYA PRADESH,2003,2615,221,382,1475,470,7,2555
MAHARASHTRA,2003,1268,116,417,541,119,4,1197
MAHARASHTRA,2003,18,1,6,8,0,0,15
MAHARASHTRA,2003,1250,115,411,533,119,4,1182
MANIPUR,2003,18,0,7,10,0,1,18
MANIPUR,2003,0,0,0,0,0,0,0
MANIPUR,2003,18,0,7,10,0,1,18
MEGHALAYA,2003,40,5,15,14,1,1,36
MEGHALAYA,2003,5,2,1,1,0,0,4
MEGHALAYA,2003,35,3,14,13,1,1,32
MIZORAM,2003,54,3,6,22,22,0,53
MIZORAM,2003,2,1,1,0,0,0,2
MIZORAM,2003,52,2,5,22,22,0,51
NAGALAND,2003,14,0,0,14,0,0,14
NAGALAND,2003,0,0,0,0,0,0,0
NAGALAND,2003,14,0,0,14,0,0,14
ODISHA,2003,725,18,32,586,83,1,720
ODISHA,2003,0,0,0,0,0,0,0
ODISHA,2003,725,18,32,586,83,1,720
PUDUCHERRY,2003,2,0,0,1,0,0,1
PUDUCHERRY,2003,0,0,0,0,0,0,0
PUDUCHERRY,2003,2,0,0,1,0,0,1
PUNJAB,2003,380,14,34,262,63,1,374
PUNJAB,2003,9,2,2,5,0,0,9
PUNJAB,2003,371,12,32,257,63,1,365
RAJASTHAN,2003,1050,11,31,751,243,7,1043
RAJASTHAN,2003,32,0,2,24,5,0,31
RAJASTHAN,2003,1018,11,29,727,238,7,1012
SIKKIM,2003,10,4,1,1,0,0,6
SIKKIM,2003,0,0,0,0,0,0,0
SIKKIM,2003,10,4,1,1,0,0,6
TAMIL NADU,2003,557,14,21,360,149,1,545
TAMIL NADU,2003,40,7,17,12,1,0,37
TAMIL NADU,2003,517,7,4,348,148,1,508
TRIPURA,2003,114,0,0,102,12,0,114
TRIPURA,2003,0,0,0,0,0,0,0
TRIPURA,2003,114,0,0,102,12,0,114
UTTAR PRADESH,2003,911,75,207,477,117,2,878
UTTAR PRADESH,2003,10,2,5,2,0,0,9
UTTAR PRADESH,2003,901,73,202,475,117,2,869
UTTARAKHAND,2003,107,4,6,83,13,0,106
UTTARAKHAND,2003,2,0,0,2,0,0,2
UTTARAKHAND,2003,105,4,6,81,13,0,104
WEST BENGAL,2003,1002,7,4,826,158,2,997
WEST BENGAL,2003,15,2,0,12,0,0,14
WEST BENGAL,2003,987,5,4,814,158,2,983
ANDAMAN & NICOBAR ISLANDS,2004,10,1,7,1,1,0,10
ANDAMAN & NICOBAR ISLANDS,2004,0,0,0,0,0,0,0
ANDAMAN & NICOBAR ISLANDS,2004,10,1,7,1,1,0,10
ANDHRA PRADESH,2004,1016,145,163,516,130,7,961
ANDHRA PRADESH,2004,5,0,3,1,0,0,4
ANDHRA PRADESH,2004,1011,145,160,515,130,7,957
ARUNACHAL PRADESH,2004,42,9,0,31,0,0,40
ARUNACHAL PRADESH,2004,0,0,0,0,0,0,0
ARUNACHAL PRADESH,2004,42,9,0,31,0,0,40
ASSAM,2004,1171,0,0,857,293,14,1164
ASSAM,2004,15,0,0,14,1,0,15
ASSAM,2004,1156,0,0,843,292,14,1149
BIHAR,2004,1390,3,0,1018,363,6,1390
BIHAR,2004,6,0,0,5,1,0,6
BIHAR,2004,1384,3,0,1013,362,6,1384
CHANDIGARH,2004,19,5,3,5,1,0,14
CHANDIGARH,2004,1,1,0,0,0,0,1
CHANDIGARH,2004,18,4,3,5,1,0,13
CHHATTISGARH,2004,969,61,233,426,226,9,955
CHHATTISGARH,2004,78,6,30,30,9,1,76
CHHATTISGARH,2004,891,55,203,396,217,8,879
DADRA & NAGAR HAVELI,2004,7,0,0,6,1,0,7
DADRA & NAGAR HAVELI,2004,0,0,0,0,0,0,0
DADRA & NAGAR HAVELI,2004,7,0,0,6,1,0,7
DAMAN & DIU,2004,1,0,1,0,0,0,1
DAMAN & DIU,2004,0,0,0,0,0,0,0
DAMAN & DIU,2004,1,0,1,0,0,0,1
DELHI,2004,551,126,77,282,6,0,491
DELHI,2004,16,7,6,2,0,0,15
DELHI,2004,535,119,71,280,6,0,476
GOA,2004,37,7,5,12,5,0,29
GOA,2004,1,0,1,0,0,0,1
GOA,2004,36,7,4,12,5,0,28
GUJARAT,2004,339,27,57,194,47,2,327
GUJARAT,2004,14,2,2,7,3,0,14
GUJARAT,2004,325,25,55,187,44,2,313
HARYANA,2004,386,2,20,315,47,0,384
HARYANA,2004,20,0,3,13,4,0,20
HARYANA,2004,366,2,17,302,43,0,364
HIMACHAL PRADESH,2004,153,11,17,68,48,5,149
HIMACHAL PRADESH,2004,8,2,1,3,2,0,8
HIMACHAL PRADESH,2004,145,9,16,65,46,5,141
JAMMU & KASHMIR,2004,218,0,2,170,44,0,216
JAMMU & KASHMIR,2004,1,0,0,1,0,0,1
JAMMU & KASHMIR,2004,217,0,2,169,44,0,215
JHARKHAND,2004,797,0,43,676,78,0,797
JHARKHAND,2004,18,0,4,11,3,0,18
JHARKHAND,2004,779,0,39,665,75,0,779
KARNATAKA,2004,291,15,12,201,48,0,276
KARNATAKA,2004,7,1,0,4,0,0,5
KARNATAKA,2004,284,14,12,197,48,0,271
KERALA,2004,480,36,104,258,57,6,461
KERALA,2004,3,0,2,1,0,0,3
KERALA,2004,477,36,102,257,57,6,458
LAKSHADWEEP,2004,0,0,0,0,0,0,0
LAKSHADWEEP,2004,0,0,0,0,0,0,0
LAKSHADWEEP,2004,0,0,0,0,0,0,0
MADHYA PRADESH,2004,2875,280,338,1673,478,14,2783
MADHYA PRADESH,2004,63,5,24,24,7,0,60
MADHYA PRADESH,2004,2812,275,314,1649,471,14,2723
MAHARASHTRA,2004,1388,133,419,627,123,5,1307
MAHARASHTRA,2004,31,5,15,8,1,0,29
MAHARASHTRA,2004,1357,128,404,619,122,5,1278
MANIPUR,2004,31,0,2,20,5,0,27
MANIPUR,2004,0,0,0,0,0,0,0
MANIPUR,2004,31,0,2,20,5,0,27
MEGHALAYA,2004,54,8,9,34,0,0,51
MEGHALAYA,2004,4,3,0,1,0,0,4
MEGHALAYA,2004,50,5,9,33,0,0,47
MIZORAM,2004,20,0,0,12,8,0,20
MIZORAM,2004,0,0,0,0,0,0,0
MIZORAM,2004,20,0,0,12,8,0,20
NAGALAND,2004,18,0,0,17,0,0,17
NAGALAND,2004,0,0,0,0,0,0,0
NAGALAND,2004,18,0,0,17,0,0,17
ODISHA,2004,770,2,2,616,123,0,743
ODISHA,2004,1,1,0,0,0,0,1
ODISHA,2004,769,1,2,616,123,0,742
PUDUCHERRY,2004,4,0,4,0,0,0,4
PUDUCHERRY,2004,0,0,0,0,0,0,0
PUDUCHERRY,2004,4,0,4,0,0,0,4
PUNJAB,2004,390,12,35,262,74,0,383
PUNJAB,2004,65,2,6,45,12,0,65
PUNJAB,2004,325,10,29,217,62,0,318
RAJASTHAN,2004,1038,41,86,645,249,7,1028
RAJASTHAN,2004,39,6,7,17,9,0,39
RAJASTHAN,2004,999,35,79,628,240,7,989
SIKKIM,2004,3,1,1,0,2,0,4
SIKKIM,2004,0,0,0,0,0,0,0
SIKKIM,2004,3,1,1,0,2,0,4
TAMIL NADU,2004,618,50,85,417,30,3,585
TAMIL NADU,2004,36,0,7,29,0,0,36
TAMIL NADU,2004,582,50,78,388,30,3,549
TRIPURA,2004,160,7,14,109,23,0,153
TRIPURA,2004,1,0,1,0,0,0,1
TRIPURA,2004,159,7,13,109,23,0,152
UTTAR PRADESH,2004,1397,99,242,838,163,2,1344
UTTAR PRADESH,2004,35,2,21,9,3,0,35
UTTAR PRADESH,2004,1362,97,221,829,160,2,1309
UTTARAKHAND,2004,115,6,9,72,26,0,113
UTTARAKHAND,2004,13,0,1,8,4,0,13
UTTARAKHAND,2004,102,6,8,64,22,0,100
WEST BENGAL,2004,1475,3,14,965,490,1,1473
WEST BENGAL,2004,24,0,0,17,7,0,24
WEST BENGAL,2004,1451,3,14,948,483,1,1449
ANDAMAN & NICOBAR ISLANDS,2005,4,0,2,2,0,0,4
ANDAMAN & NICOBAR ISLANDS,2005,0,0,0,0,0,0,0
ANDAMAN & NICOBAR ISLANDS,2005,4,0,2,2,0,0,4
ANDHRA PRADESH,2005,935,106,177,490,124,6,903
ANDHRA PRADESH,2005,18,4,0,6,6,0,16
ANDHRA PRADESH,2005,917,102,177,484,118,6,887
ARUNACHAL PRADESH,2005,35,5,2,25,0,0,32
ARUNACHAL PRADESH,2005,0,0,0,0,0,0,0
ARUNACHAL PRADESH,2005,35,5,2,25,0,0,32
ASSAM,2005,1238,34,37,847,286,15,1219
ASSAM,2005,7,1,0,3,2,1,7
ASSAM,2005,1231,33,37,844,284,14,1212
BIHAR,2005,1147,6,2,872,267,0,1147
BIHAR,2005,10,0,0,8,2,0,10
BIHAR,2005,1137,6,2,864,265,0,1137
CHANDIGARH,2005,33,4,10,5,7,0,26
CHANDIGARH,2005,1,0,1,0,0,0,1
CHANDIGARH,2005,32,4,9,5,7,0,25
CHHATTISGARH,2005,990,112,255,392,200,16,975
CHHATTISGARH,2005,110,10,33,39,27,0,109
CHHATTISGARH,2005,880,102,222,353,173,16,866
DADRA & NAGAR HAVELI,2005,5,0,0,5,0,0,5
DADRA & NAGAR HAVELI,2005,0,0,0,0,0,0,0
DADRA & NAGAR HAVELI,2005,5,0,0,5,0,0,5
DAMAN & DIU,2005,2,1,0,0,1,0,2
DAMAN & DIU,2005,0,0,0,0,0,0,0
DAMAN & DIU,2005,2,1,0,0,1,0,2
DELHI,2005,658,120,55,404,25,2,606
DELHI,2005,32,9,10,2,0,0,21
DELHI,2005,626,111,45,402,25,2,585
GOA,2005,20,4,7,4,1,0,16
GOA,2005,1,0,0,0,0,0,0
GOA,2005,19,4,7,4,1,0,16
GUJARAT,2005,324,28,44,218,16,0,306
GUJARAT,2005,19,4,5,8,0,0,17
GUJARAT,2005,305,24,39,210,16,0,289
HARYANA,2005,461,34,97,181,143,6,461
HARYANA,2005,15,0,3,10,2,0,15
HARYANA,2005,446,34,94,171,141,6,446
HIMACHAL PRADESH,2005,141,17,30,63,18,2,130
HIMACHAL PRADESH,2005,5,1,2,2,0,0,5
HIMACHAL PRADESH,2005,136,16,28,61,18,2,125
JAMMU & KASHMIR,2005,201,0,3,153,42,2,200
JAMMU & KASHMIR,2005,0,0,0,0,0,0,0
JAMMU & KASHMIR,2005,201,0,3,153,42,2,200
JHARKHAND,2005,753,7,12,384,343,1,747
JHARKHAND,2005,120,4,8,65,41,0,118
JHARKHAND,2005,633,3,4,319,302,1,629
KARNATAKA,2005,343,13,21,234,61,0,329
KARNATAKA,2005,5,0,0,3,2,0,5
KARNATAKA,2005,338,13,21,231,59,0,324
KERALA,2005,478,31,86,236,90,8,451
KERALA,2005,12,1,4,5,0,1,11
KERALA,2005,466,30,82,231,90,7,440
LAKSHADWEEP,2005,0,0,0,0,0,0,0
LAKSHADWEEP,2005,0,0,0,0,0,0,0
LAKSHADWEEP,2005,0,0,0,0,0,0,0
MADHYA PRADESH,2005,2921,294,474,1396,629,26,2819
MADHYA PRADESH,2005,141,18,43,57,13,1,132
MADHYA PRADESH,2005,2780,276,431,1339,616,25,2687
MAHARASHTRA,2005,1545,132,421,735,174,2,1464
MAHARASHTRA,2005,38,5,13,14,3,0,35
MAHARASHTRA,2005,1507,127,408,721,171,2,1429
MANIPUR,2005,25,1,0,14,7,0,22
MANIPUR,2005,1,0,0,0,1,0,1
MANIPUR,2005,24,1,0,14,6,0,21
MEGHALAYA,2005,63,10,32,8,4,0,54
MEGHALAYA,2005,4,0,3,0,0,0,3
MEGHALAYA,2005,59,10,29,8,4,0,51
MIZORAM,2005,37,0,30,7,0,0,37
MIZORAM,2005,0,0,0,0,0,0,0
MIZORAM,2005,37,0,30,7,0,0,37
NAGALAND,2005,17,0,0,12,2,0,14
NAGALAND,2005,0,0,0,0,0,0,0
NAGALAND,2005,17,0,0,12,2,0,14
ODISHA,2005,799,0,10,636,132,3,781
ODISHA,2005,7,0,0,6,1,0,7
ODISHA,2005,792,0,10,630,131,3,774
PUDUCHERRY,2005,6,0,2,3,0,0,5
PUDUCHERRY,2005,0,0,0,0,0,0,0
PUDUCHERRY,2005,6,0,2,3,0,0,5
PUNJAB,2005,398,19,23,239,108,0,389
PUNJAB,2005,50,1,11,25,11,0,48
PUNJAB,2005,348,18,12,214,97,0,341
RAJASTHAN,2005,993,44,181,515,216,16,972
RAJASTHAN,2005,33,5,10,11,7,0,33
RAJASTHAN,2005,960,39,171,504,209,16,939
SIKKIM,2005,18,5,7,2,2,0,16
SIKKIM,2005,1,1,0,0,0,0,1
SIKKIM,2005,17,4,7,2,2,0,15
TAMIL NADU,2005,571,28,58,396,60,0,542
TAMIL NADU,2005,11,0,0,8,2,0,10
TAMIL NADU,2005,560,28,58,388,58,0,532
TRIPURA,2005,162,13,4,129,13,0,159
TRIPURA,2005,0,0,0,0,0,0,0
TRIPURA,2005,162,13,4,129,13,0,159
UTTAR PRADESH,2005,1217,103,247,656,162,5,1173
UTTAR PRADESH,2005,70,0,18,52,0,0,70
UTTAR PRADESH,2005,1147,103,229,604,162,5,1103
UTTARAKHAND,2005,133,3,12,95,20,0,130
UTTARAKHAND,2005,3,0,0,2,1,0,3
UTTARAKHAND,2005,130,3,12,93,19,0,127
WEST BENGAL,2005,1686,0,3,1451,228,1,1683
WEST BENGAL,2005,36,0,0,31,5,0,36
WEST BENGAL,2005,1650,0,3,1420,223,1,1647
ANDAMAN & NICOBAR ISLANDS,2006,6,2,1,1,0,0,4
ANDAMAN & NICOBAR ISLANDS,2006,0,0,0,0,0,0,0
ANDAMAN & NICOBAR ISLANDS,2006,6,2,1,1,0,0,4
ANDHRA PRADESH,2006,1049,128,238,536,91,10,1003
ANDHRA PRADESH,2006,1,0,0,1,0,0,1
ANDHRA PRADESH,2006,1048,128,238,535,91,10,1002
ARUNACHAL PRADESH,2006,37,0,0,34,3,0,37
ARUNACHAL PRADESH,2006,0,0,0,0,0,0,0
ARUNACHAL PRADESH,2006,37,0,0,34,3,0,37
ASSAM,2006,1244,21,32,892,289,2,1236
ASSAM,2006,12,3,0,6,3,0,12
ASSAM,2006,1232,18,32,886,286,2,1224
BIHAR,2006,1232,0,17,956,250,9,1232
BIHAR,2006,7,0,2,3,2,0,7
BIHAR,2006,1225,0,15,953,248,9,1225
CHANDIGARH,2006,19,2,6,4,4,0,16
CHANDIGARH,2006,5,1,2,1,0,0,4
CHANDIGARH,2006,14,1,4,3,4,0,12
CHHATTISGARH,2006,995,104,316,337,183,27,967
CHHATTISGARH,2006,97,12,33,29,15,2,91
CHHATTISGARH,2006,898,92,283,308,168,25,876
DADRA & NAGAR HAVELI,2006,6,1,2,1,0,0,4
DADRA & NAGAR HAVELI,2006,0,0,0,0,0,0,0
DADRA & NAGAR HAVELI,2006,6,1,2,1,0,0,4
DAMAN & DIU,2006,3,0,0,2,0,0,2
DAMAN & DIU,2006,0,0,0,0,0,0,0
DAMAN & DIU,2006,3,0,0,2,0,0,2
DELHI,2006,623,111,267,155,21,2,556
DELHI,2006,26,4,12,7,0,0,23
DELHI,2006,597,107,255,148,21,2,533
GOA,2006,21,4,9,5,1,1,20
GOA,2006,1,0,0,1,0,0,1
GOA,2006,20,4,9,4,1,1,19
GUJARAT,2006,354,30,62,213,28,1,334
GUJARAT,2006,16,2,0,14,0,0,16
GUJARAT,2006,338,28,62,199,28,1,318
HARYANA,2006,608,22,153,376,51,5,607
HARYANA,2006,10,0,0,8,2,0,10
HARYANA,2006,598,22,153,368,49,5,597
HIMACHAL PRADESH,2006,113,9,27,66,4,1,107
HIMACHAL PRADESH,2006,7,2,1,2,0,0,5
HIMACHAL PRADESH,2006,106,7,26,64,4,1,102
JAMMU & KASHMIR,2006,250,8,0,193,48,1,250
JAMMU & KASHMIR,2006,0,0,0,0,0,0,0
JAMMU & KASHMIR,2006,250,8,0,193,48,1,250
JHARKHAND,2006,799,45,198,419,133,2,797
JHARKHAND,2006,94,6,21,50,17,0,94
JHARKHAND,2006,705,39,177,369,116,2,703
KARNATAKA,2006,400,16,46,268,45,2,377
KARNATAKA,2006,2,1,0,1,0,0,2
KARNATAKA,2006,398,15,46,267,45,2,375
KERALA,2006,601,59,127,281,96,7,570
KERALA,2006,28,3,9,8,3,1,24
KERALA,2006,573,56,118,273,93,6,546
LAKSHADWEEP,2006,0,0,0,0,0,0,0
LAKSHADWEEP,2006,0,0,0,0,0,0,0
LAKSHADWEEP,2006,0,0,0,0,0,0,0
MADHYA PRADESH,2006,2900,96,710,1402,662,7,2877
MADHYA PRADESH,2006,29,5,5,12,4,0,26
MADHYA PRADESH,2006,2871,91,705,1390,658,7,2851
MAHARASHTRA,2006,1500,127,445,707,140,4,1423
MAHARASHTRA,2006,36,9,11,8,4,0,32
MAHARASHTRA,2006,1464,118,434,699,136,4,1391
MANIPUR,2006,40,4,9,17,6,0,36
MANIPUR,2006,0,0,0,0,0,0,0
MANIPUR,2006,40,4,9,17,6,0,36
MEGHALAYA,2006,74,11,23,23,3,0,60
MEGHALAYA,2006,0,0,0,0,0,0,0
MEGHALAYA,2006,74,11,23,23,3,0,60
MIZORAM,2006,72,19,9,32,5,0,65
MIZORAM,2006,0,0,0,0,0,0,0
MIZORAM,2006,72,19,9,32,5,0,65
NAGALAND,2006,23,1,4,11,1,0,17
NAGALAND,2006,0,0,0,0,0,0,0
NAGALAND,2006,23,1,4,11,1,0,17
ODISHA,2006,985,51,27,730,152,2,962
ODISHA,2006,0,0,0,0,0,0,0
ODISHA,2006,985,51,27,730,152,2,962
PUDUCHERRY,2006,9,1,5,1,0,0,7
PUDUCHERRY,2006,0,0,0,0,0,0,0
PUDUCHERRY,2006,9,1,5,1,0,0,7
PUNJAB,2006,442,19,26,319,64,0,428
PUNJAB,2006,1,0,0,1,0,0,1
PUNJAB,2006,441,19,26,318,64,0,427
RAJASTHAN,2006,1085,80,197,555,214,5,1051
RAJASTHAN,2006,42,3,12,22,4,0,41
RAJASTHAN,2006,1043,77,185,533,210,5,1010
SIKKIM,2006,20,4,5,3,0,0,12
SIKKIM,2006,0,0,0,0,0,0,0
SIKKIM,2006,20,4,5,3,0,0,12
TAMIL NADU,2006,457,34,68,275,55,2,434
TAMIL NADU,2006,1,1,0,0,0,0,1
TAMIL NADU,2006,456,33,68,275,55,2,433
TRIPURA,2006,189,4,34,135,17,1,191
TRIPURA,2006,4,0,4,0,0,0,4
TRIPURA,2006,185,4,30,135,17,1,187
UTTAR PRADESH,2006,1314,56,273,780,184,3,1296
UTTAR PRADESH,2006,0,0,0,0,0,0,0
UTTAR PRADESH,2006,1314,56,273,780,184,3,1296
UTTARAKHAND,2006,147,7,15,106,18,0,146
UTTARAKHAND,2006,6,3,0,2,1,0,6
UTTARAKHAND,2006,141,4,15,104,17,0,140
WEST BENGAL,2006,1731,5,13,1477,234,0,1729
WEST BENGAL,2006,6,0,0,6,0,0,6
WEST BENGAL,2006,1725,5,13,1471,234,0,1723
ANDAMAN & NICOBAR ISLANDS,2007,3,0,3,0,0,0,3
ANDAMAN & NICOBAR ISLANDS,2007,0,0,0,0,0,0,0
ANDAMAN & NICOBAR ISLANDS,2007,3,0,3,0,0,0,3
ANDHRA PRADESH,2007,1070,110,201,572,128,7,1018
ANDHRA PRADESH,2007,7,0,4,3,0,0,7
ANDHRA PRADESH,2007,1063,110,197,569,128,7,1011
ARUNACHAL PRADESH,2007,48,0,0,42,5,0,47
ARUNACHAL PRADESH,2007,0,0,0,0,0,0,0
ARUNACHAL PRADESH,2007,48,0,0,42,5,0,47
ASSAM,2007,1437,0,40,898,485,14,1437
ASSAM,2007,1,0,1,0,0,0,1
ASSAM,2007,1436,0,39,898,485,14,1436
BIHAR,2007,1555,28,79,1186,253,0,1546
BIHAR,2007,2,2,0,0,0,0,2
BIHAR,2007,1553,26,79,1186,253,0,1544
CHANDIGARH,2007,22,3,2,11,3,0,19
CHANDIGARH,2007,2,1,0,0,0,0,1
CHANDIGARH,2007,20,2,2,11,3,0,18
CHHATTISGARH,2007,982,117,219,500,101,13,950
CHHATTISGARH,2007,63,10,31,14,6,0,61
CHHATTISGARH,2007,919,107,188,486,95,13,889
DADRA & NAGAR HAVELI,2007,7,2,4,0,0,0,6
DADRA & NAGAR HAVELI,2007,0,0,0,0,0,0,0
DADRA & NAGAR HAVELI,2007,7,2,4,0,0,0,6
DAMAN & DIU,2007,1,0,0,1,0,0,1
DAMAN & DIU,2007,0,0,0,0,0,0,0
DAMAN & DIU,2007,1,0,0,1,0,0,1
DELHI,2007,598,94,228,179,24,1,526
DELHI,2007,18,2,9,5,0,0,16
DELHI,2007,580,92,219,174,24,1,510
GOA,2007,20,4,7,4,1,0,16
GOA,2007,1,0,1,0,0,0,1
GOA,2007,19,4,6,4,1,0,15
GUJARAT,2007,316,30,51,180,37,1,299
GUJARAT,2007,3,0,1,0,1,0,2
GUJARAT,2007,313,30,50,180,36,1,297
HARYANA,2007,488,26,79,322,41,3,471
HARYANA,2007,3,2,0,1,0,0,3
HARYANA,2007,485,24,79,321,41,3,468
HIMACHAL PRADESH,2007,159,19,46,58,23,2,148
HIMACHAL PRADESH,2007,2,0,0,0,1,0,1
HIMACHAL PRADESH,2007,157,19,46,58,22,2,147
JAMMU & KASHMIR,2007,288,5,10,176,97,0,288
JAMMU & KASHMIR,2007,0,0,0,0,0,0,0
JAMMU & KASHMIR,2007,288,5,10,176,97,0,288
JHARKHAND,2007,855,15,8,639,188,5,855
JHARKHAND,2007,0,0,0,0,0,0,0
JHARKHAND,2007,855,15,8,639,188,5,855
KARNATAKA,2007,436,32,32,297,48,7,416
KARNATAKA,2007,2,0,1,1,0,0,2
KARNATAKA,2007,434,32,31,296,48,7,414
KERALA,2007,512,45,115,262,63,5,490
KERALA,2007,21,5,4,11,0,0,20
KERALA,2007,491,40,111,251,63,5,470
LAKSHADWEEP,2007,1,0,0,1,0,0,1
LAKSHADWEEP,2007,0,0,0,0,0,0,0
LAKSHADWEEP,2007,1,0,0,1,0,0,1
MADHYA PRADESH,2007,3010,287,692,1399,525,43,2946
MADHYA PRADESH,2007,49,7,23,14,4,0,48
MADHYA PRADESH,2007,2961,280,669,1385,521,43,2898
MAHARASHTRA,2007,1451,125,393,659,168,13,1358
MAHARASHTRA,2007,40,5,9,13,9,0,36
MAHARASHTRA,2007,1411,120,384,646,159,13,1322
MANIPUR,2007,20,2,0,14,2,0,18
MANIPUR,2007,1,0,0,0,0,0,0
MANIPUR,2007,19,2,0,14,2,0,18
MEGHALAYA,2007,82,12,19,36,2,0,69
MEGHALAYA,2007,9,0,1,6,0,0,7
MEGHALAYA,2007,73,12,18,30,2,0,62
MIZORAM,2007,83,23,18,10,7,2,60
MIZORAM,2007,2,0,0,0,0,1,1
MIZORAM,2007,81,23,18,10,7,1,59
NAGALAND,2007,13,0,3,6,4,0,13
NAGALAND,2007,1,0,1,0,0,0,1
NAGALAND,2007,12,0,2,6,4,0,12
ODISHA,2007,939,41,42,659,188,0,930
ODISHA,2007,0,0,0,0,0,0,0
ODISHA,2007,939,41,42,659,188,0,930
PUDUCHERRY,2007,9,0,2,6,0,0,8
PUDUCHERRY,2007,0,0,0,0,0,0,0
PUDUCHERRY,2007,9,0,2,6,0,0,8
PUNJAB,2007,519,38,71,302,79,3,493
PUNJAB,2007,7,0,6,1,0,0,7
PUNJAB,2007,512,38,65,301,79,3,486
RAJASTHAN,2007,1238,79,286,639,187,8,1199
RAJASTHAN,2007,42,7,13,15,3,1,39
RAJASTHAN,2007,1196,72,273,624,184,7,1160
SIKKIM,2007,24,3,5,5,1,0,14
SIKKIM,2007,4,0,1,0,0,0,1
SIKKIM,2007,20,3,4,5,1,0,13
TAMIL NADU,2007,523,41,89,346,35,1,512
TAMIL NADU,2007,2,0,1,0,0,0,1
TAMIL NADU,2007,521,41,88,346,35,1,511
TRIPURA,2007,157,14,16,113,11,0,154
TRIPURA,2007,0,0,0,0,0,0,0
TRIPURA,2007,157,14,16,113,11,0,154
UTTAR PRADESH,2007,1648,109,349,910,267,0,1635
UTTAR PRADESH,2007,1,0,0,0,0,0,0
UTTAR PRADESH,2007,1647,109,349,910,267,0,1635
UTTARAKHAND,2007,117,9,7,74,26,0,116
UTTARAKHAND,2007,8,2,4,2,0,0,8
UTTARAKHAND,2007,109,7,3,72,26,0,108
WEST BENGAL,2007,2106,42,36,1478,531,5,2092
WEST BENGAL,2007,114,2,3,81,25,0,111
WEST BENGAL,2007,1992,40,33,1397,506,5,1981
ANDAMAN & NICOBAR ISLANDS,2008,12,1,7,3,1,0,12
ANDAMAN & NICOBAR ISLANDS,2008,0,0,0,0,0,0,0
ANDAMAN & NICOBAR ISLANDS,2008,12,1,7,3,1,0,12
ANDHRA PRADESH,2008,1257,126,237,660,174,11,1208
ANDHRA PRADESH,2008,13,2,1,5,1,2,11
ANDHRA PRADESH,2008,1244,124,236,655,173,9,1197
ARUNACHAL PRADESH,2008,42,7,0,31,0,0,38
ARUNACHAL PRADESH,2008,0,0,0,0,0,0,0
ARUNACHAL PRADESH,2008,42,7,0,31,0,0,38
ASSAM,2008,1438,5,20,849,541,21,1436
ASSAM,2008,7,0,0,5,2,0,7
ASSAM,2008,1431,5,20,844,539,21,1429
BIHAR,2008,1302,11,80,1028,159,24,1302
BIHAR,2008,3,0,0,1,2,0,3
BIHAR,2008,1299,11,80,1027,157,24,1299
CHANDIGARH,2008,20,3,7,7,1,0,18
CHANDIGARH,2008,3,0,2,1,0,0,3
CHANDIGARH,2008,17,3,5,6,1,0,15
CHHATTISGARH,2008,978,80,307,388,176,3,954
CHHATTISGARH,2008,31,3,15,12,1,0,31
CHHATTISGARH,2008,947,77,292,376,175,3,923
DADRA & NAGAR HAVELI,2008,6,1,2,3,0,0,6
DADRA & NAGAR HAVELI,2008,0,0,0,0,0,0,0
DADRA & NAGAR HAVELI,2008,6,1,2,3,0,0,6
DAMAN & DIU,2008,0,0,0,0,0,0,0
DAMAN & DIU,2008,0,0,0,0,0,0,0
DAMAN & DIU,2008,0,0,0,0,0,0,0
DELHI,2008,466,95,135,133,30,6,399
DELHI,2008,37,12,8,10,1,4,35
DELHI,2008,429,83,127,123,29,2,364
GOA,2008,30,6,11,7,3,2,29
GOA,2008,0,0,0,0,0,0,0
GOA,2008,30,6,11,7,3,2,29
GUJARAT,2008,374,27,57,217,57,1,359
GUJARAT,2008,4,1,2,1,0,0,4
GUJARAT,2008,370,26,55,216,57,1,355
HARYANA,2008,631,22,38,495,61,5,621
HARYANA,2008,8,1,2,4,0,1,8
HARYANA,2008,623,21,36,491,61,4,613
HIMACHAL PRADESH,2008,157,16,44,68,20,1,149
HIMACHAL PRADESH,2008,1,1,0,0,0,0,1
HIMACHAL PRADESH,2008,156,15,44,68,20,1,148
JAMMU & KASHMIR,2008,219,0,3,155,59,0,217
JAMMU & KASHMIR,2008,0,0,0,0,0,0,0
JAMMU & KASHMIR,2008,219,0,3,155,59,0,217
JHARKHAND,2008,791,2,5,662,119,2,790
JHARKHAND,2008,12,0,0,7,5,0,12
JHARKHAND,2008,779,2,5,655,114,2,778
KARNATAKA,2008,446,24,52,301,47,1,425
KARNATAKA,2008,0,0,0,0,0,0,0
KARNATAKA,2008,446,24,52,301,47,1,425
KERALA,2008,568,51,139,274,73,6,543
KERALA,2008,17,6,6,4,1,0,17
KERALA,2008,551,45,133,270,72,6,526
LAKSHADWEEP,2008,2,0,0,1,1,0,2
LAKSHADWEEP,2008,0,0,0,0,0,0,0
LAKSHADWEEP,2008,2,0,0,1,1,0,2
MADHYA PRADESH,2008,2937,227,596,1548,477,20,2868
MADHYA PRADESH,2008,52,9,20,15,5,0,49
MADHYA PRADESH,2008,2885,218,576,1533,472,20,2819
MAHARASHTRA,2008,1558,135,441,707,161,5,1449
MAHARASHTRA,2008,35,5,8,11,6,1,31
MAHARASHTRA,2008,1523,130,433,696,155,4,1418
MANIPUR,2008,38,8,8,12,1,0,29
MANIPUR,2008,0,0,0,0,0,0,0
MANIPUR,2008,38,8,8,12,1,0,29
MEGHALAYA,2008,88,17,14,47,4,0,82
MEGHALAYA,2008,5,3,0,1,0,0,4
MEGHALAYA,2008,83,14,14,46,4,0,78
MIZORAM,2008,77,4,5,49,10,0,68
MIZORAM,2008,3,1,1,1,0,0,3
MIZORAM,2008,74,3,4,48,10,0,65
NAGALAND,2008,19,0,0,19,0,0,19
NAGALAND,2008,1,0,0,1,0,0,1
NAGALAND,2008,18,0,0,18,0,0,18
ODISHA,2008,1113,27,24,645,388,12,1096
ODISHA,2008,17,0,1,13,1,0,15
ODISHA,2008,1096,27,23,632,387,12,1081
PUDUCHERRY,2008,8,1,3,3,1,0,8
PUDUCHERRY,2008,0,0,0,0,0,0,0
PUDUCHERRY,2008,8,1,3,3,1,0,8
PUNJAB,2008,517,36,45,359,47,5,492
PUNJAB,2008,2,0,0,1,1,0,2
PUNJAB,2008,515,36,45,358,46,5,490
RAJASTHAN,2008,1355,116,275,706,219,10,1326
RAJASTHAN,2008,40,6,7,21,4,0,38
RAJASTHAN,2008,1315,110,268,685,215,10,1288
SIKKIM,2008,20,3,1,8,0,0,12
SIKKIM,2008,1,0,0,0,0,0,0
SIKKIM,2008,19,3,1,8,0,0,12
TAMIL NADU,2008,573,29,131,340,46,0,546
TAMIL NADU,2008,1,0,0,0,0,0,0
TAMIL NADU,2008,572,29,131,340,46,0,546
TRIPURA,2008,204,23,65,96,4,0,188
TRIPURA,2008,0,0,0,0,0,0,0
TRIPURA,2008,204,23,65,96,4,0,188
UTTAR PRADESH,2008,1871,171,685,785,186,0,1827
UTTAR PRADESH,2008,1,0,0,0,1,0,1
UTTAR PRADESH,2008,1870,171,685,785,185,0,1826
UTTARAKHAND,2008,87,4,5,64,14,0,87
UTTARAKHAND,2008,6,2,1,2,1,0,6
UTTARAKHAND,2008,81,2,4,62,13,0,81
WEST BENGAL,2008,2263,53,54,1629,504,1,2241
WEST BENGAL,2008,9,2,1,1,0,0,4
WEST BENGAL,2008,2254,51,53,1628,504,1,2237
ANDAMAN & NICOBAR ISLANDS,2009,18,3,7,5,1,0,16
ANDAMAN & NICOBAR ISLANDS,2009,0,0,0,0,0,0,0
ANDAMAN & NICOBAR ISLANDS,2009,18,3,7,5,1,0,16
ANDHRA PRADESH,2009,1188,167,208,642,116,14,1147
ANDHRA PRADESH,2009,2,0,2,0,0,0,2
ANDHRA PRADESH,2009,1186,167,206,642,116,14,1145
ARUNACHAL PRADESH,2009,59,12,0,42,1,0,55
ARUNACHAL PRADESH,2009,0,0,0,0,0,0,0
ARUNACHAL PRADESH,2009,59,12,0,42,1,0,55
ASSAM,2009,1631,6,3,1230,377,14,1630
ASSAM,2009,9,0,0,7,2,0,9
ASSAM,2009,1622,6,3,1223,375,14,1621
BIHAR,2009,929,19,32,765,101,0,917
BIHAR,2009,1,0,0,1,0,0,1
BIHAR,2009,928,19,32,764,101,0,916
CHANDIGARH,2009,29,8,10,8,0,0,26
CHANDIGARH,2009,0,0,0,0,0,0,0
CHANDIGARH,2009,29,8,10,8,0,0,26
CHHATTISGARH,2009,976,227,87,460,113,9,896
CHHATTISGARH,2009,24,2,8,6,5,2,23
CHHATTISGARH,2009,952,225,79,454,108,7,873
DADRA & NAGAR HAVELI,2009,4,2,0,2,0,0,4
DADRA & NAGAR HAVELI,2009,0,0,0,0,0,0,0
DADRA & NAGAR HAVELI,2009,4,2,0,2,0,0,4
DAMAN & DIU,2009,1,0,0,0,0,0,0
DAMAN & DIU,2009,0,0,0,0,0,0,0
DAMAN & DIU,2009,1,0,0,0,0,0,0
DELHI,2009,469,72,188,141,20,1,422
DELHI,2009,19,3,5,6,2,0,16
DELHI,2009,450,69,183,135,18,1,406
GOA,2009,47,11,21,15,2,0,49
GOA,2009,1,0,1,0,0,0,1
GOA,2009,46,11,20,15,2,0,48
GUJARAT,2009,433,27,50,308,32,1,418
GUJARAT,2009,18,2,3,10,2,0,17
GUJARAT,2009,415,25,47,298,30,1,401
HARYANA,2009,603,27,70,430,54,3,584
HARYANA,2009,12,2,0,7,1,0,10
HARYANA,2009,591,25,70,423,53,3,574
HIMACHAL PRADESH,2009,183,16,55,84,16,0,171
HIMACHAL PRADESH,2009,10,2,5,1,1,0,9
HIMACHAL PRADESH,2009,173,14,50,83,15,0,162
JAMMU & KASHMIR,2009,237,1,3,177,52,2,235
JAMMU & KASHMIR,2009,4,1,0,2,1,0,4
JAMMU & KASHMIR,2009,233,0,3,175,51,2,231
JHARKHAND,2009,719,0,5,494,216,0,715
JHARKHAND,2009,22,0,0,16,6,0,22
JHARKHAND,2009,697,0,5,478,210,0,693
KARNATAKA,2009,509,49,18,361,38,4,470
KARNATAKA,2009,18,0,0,17,1,0,18
KARNATAKA,2009,491,49,18,344,37,4,452
KERALA,2009,568,45,157,253,70,10,535
KERALA,2009,18,3,7,4,1,0,15
KERALA,2009,550,42,150,249,69,10,520
LAKSHADWEEP,2009,1,0,0,1,0,0,1
LAKSHADWEEP,2009,0,0,0,0,0,0,0
LAKSHADWEEP,2009,1,0,0,1,0,0,1
MADHYA PRADESH,2009,2998,291,704,1405,511,11,2922
MADHYA PRADESH,2009,14,1,9,2,1,0,13
MADHYA PRADESH,2009,2984,290,695,1403,510,11,2909
MAHARASHTRA,2009,1483,121,363,713,157,8,1362
MAHARASHTRA,2009,76,3,19,47,3,0,72
MAHARASHTRA,2009,1407,118,344,666,154,8,1290
MANIPUR,2009,31,5,2,9,9,1,26
MANIPUR,2009,0,0,0,0,0,0,0
MANIPUR,2009,31,5,2,9,9,1,26
MEGHALAYA,2009,112,23,19,41,7,3,93
MEGHALAYA,2009,5,2,1,1,0,0,4
MEGHALAYA,2009,107,21,18,40,7,3,89
MIZORAM,2009,83,3,3,42,30,0,78
MIZORAM,2009,3,1,0,0,0,0,1
MIZORAM,2009,80,2,3,42,30,0,77
NAGALAND,2009,22,0,0,17,5,0,22
NAGALAND,2009,0,0,0,0,0,0,0
NAGALAND,2009,22,0,0,17,5,0,22
ODISHA,2009,1023,24,57,747,182,7,1017
ODISHA,2009,6,1,0,5,0,0,6
ODISHA,2009,1017,23,57,742,182,7,1011
PUDUCHERRY,2009,1,0,1,0,0,0,1
PUDUCHERRY,2009,0,0,0,0,0,0,0
PUDUCHERRY,2009,1,0,1,0,0,0,1
PUNJAB,2009,511,48,131,258,43,1,481
PUNJAB,2009,8,2,3,3,0,0,8
PUNJAB,2009,503,46,128,255,43,1,473
RAJASTHAN,2009,1519,55,288,856,289,4,1492
RAJASTHAN,2009,36,3,7,20,4,0,34
RAJASTHAN,2009,1483,52,281,836,285,4,1458
SIKKIM,2009,18,5,5,2,2,0,14
SIKKIM,2009,0,0,0,0,0,0,0
SIKKIM,2009,18,5,5,2,2,0,14
TAMIL NADU,2009,596,34,120,390,22,2,568
TAMIL NADU,2009,4,0,3,0,0,0,3
TAMIL NADU,2009,592,34,117,390,22,2,565
TRIPURA,2009,190,22,51,79,28,0,180
TRIPURA,2009,0,0,0,0,0,0,0
TRIPURA,2009,190,22,51,79,28,0,180
UTTAR PRADESH,2009,1759,416,166,911,223,0,1716
UTTAR PRADESH,2009,2,0,1,0,0,0,1
UTTAR PRADESH,2009,1757,416,165,911,223,0,1715
UTTARAKHAND,2009,111,3,3,89,15,0,110
UTTARAKHAND,2009,6,3,1,2,0,0,6
UTTARAKHAND,2009,105,0,2,87,15,0,104
WEST BENGAL,2009,2336,18,85,1835,392,0,2330
WEST BENGAL,2009,3,0,1,1,1,0,3
WEST BENGAL,2009,2333,18,84,1834,391,0,2327
ANDAMAN & NICOBAR ISLANDS,2010,24,1,12,8,1,0,22
ANDAMAN & NICOBAR ISLANDS,2010,0,0,0,0,0,0,0
ANDAMAN & NICOBAR ISLANDS,2010,24,1,12,8,1,0,22
ANDHRA PRADESH,2010,1362,133,283,749,152,15,1332
ANDHRA PRADESH,2010,0,0,0,0,0,0,0
ANDHRA PRADESH,2010,1362,133,283,749,152,15,1332
ARUNACHAL PRADESH,2010,47,10,0,34,1,0,45
ARUNACHAL PRADESH,2010,0,0,0,0,0,0,0
ARUNACHAL PRADESH,2010,47,10,0,34,1,0,45
ASSAM,2010,1721,9,29,1116,556,10,1720
ASSAM,2010,13,0,0,10,3,0,13
ASSAM,2010,1708,9,29,1106,553,10,1707
BIHAR,2010,795,17,89,616,65,0,787
BIHAR,2010,2,1,0,0,0,0,1
BIHAR,2010,793,16,89,616,65,0,786
CHANDIGARH,2010,31,8,4,15,0,0,27
CHANDIGARH,2010,0,0,0,0,0,0,0
CHANDIGARH,2010,31,8,4,15,0,0,27
CHHATTISGARH,2010,1012,87,271,424,190,16,988
CHHATTISGARH,2010,21,2,3,13,3,0,21
CHHATTISGARH,2010,991,85,268,411,187,16,967
DADRA & NAGAR HAVELI,2010,3,1,1,0,0,0,2
DADRA & NAGAR HAVELI,2010,0,0,0,0,0,0,0
DADRA & NAGAR HAVELI,2010,3,1,1,0,0,0,2
DAMAN & DIU,2010,1,0,0,0,0,0,0
DAMAN & DIU,2010,0,0,0,0,0,0,0
DAMAN & DIU,2010,1,0,0,0,0,0,0
DELHI,2010,507,79,174,168,34,1,456
DELHI,2010,21,11,3,1,0,0,15
DELHI,2010,486,68,171,167,34,1,441
GOA,2010,36,5,14,11,0,2,32
GOA,2010,2,0,2,0,0,0,2
GOA,2010,34,5,12,11,0,2,30
GUJARAT,2010,408,28,53,261,42,2,386
GUJARAT,2010,4,0,2,1,0,0,3
GUJARAT,2010,404,28,51,260,42,2,383
HARYANA,2010,720,23,80,481,127,5,716
HARYANA,2010,15,1,1,11,2,0,15
HARYANA,2010,705,22,79,470,125,5,701
HIMACHAL PRADESH,2010,160,16,48,67,20,1,152
HIMACHAL PRADESH,2010,7,3,2,1,0,1,7
HIMACHAL PRADESH,2010,153,13,46,66,20,0,145
JAMMU & KASHMIR,2010,245,1,7,187,50,0,245
JAMMU & KASHMIR,2010,0,0,0,0,0,0,0
JAMMU & KASHMIR,2010,245,1,7,187,50,0,245
JHARKHAND,2010,773,0,0,604,169,0,773
JHARKHAND,2010,11,0,0,10,1,0,11
JHARKHAND,2010,762,0,0,594,168,0,762
KARNATAKA,2010,586,47,69,369,88,3,576
KARNATAKA,2010,2,0,0,2,0,0,2
KARNATAKA,2010,584,47,69,367,88,3,574
KERALA,2010,634,48,133,328,86,12,607
KERALA,2010,14,5,2,2,0,0,9
KERALA,2010,620,43,131,326,86,12,598
LAKSHADWEEP,2010,0,0,0,0,0,0,0
LAKSHADWEEP,2010,0,0,0,0,0,0,0
LAKSHADWEEP,2010,0,0,0,0,0,0,0
MADHYA PRADESH,2010,3135,304,826,1364,577,12,3083
MADHYA PRADESH,2010,21,1,10,4,4,0,19
MADHYA PRADESH,2010,3114,303,816,1360,573,12,3064
MAHARASHTRA,2010,1599,134,515,675,168,11,1503
MAHARASHTRA,2010,44,8,13,18,1,0,40
MAHARASHTRA,2010,1555,126,502,657,167,11,1463
MANIPUR,2010,34,2,8,20,3,0,33
MANIPUR,2010,0,0,0,0,0,0,0
MANIPUR,2010,34,2,8,20,3,0,33
MEGHALAYA,2010,149,34,26,41,17,0,118
MEGHALAYA,2010,8,4,1,1,0,0,6
MEGHALAYA,2010,141,30,25,40,17,0,112
MIZORAM,2010,92,17,15,29,17,4,82
MIZORAM,2010,3,0,1,0,0,0,1
MIZORAM,2010,89,17,14,29,17,4,81
NAGALAND,2010,16,1,2,6,6,0,15
NAGALAND,2010,1,0,1,0,0,0,1
NAGALAND,2010,15,1,1,6,6,0,14
ODISHA,2010,1025,17,44,787,159,5,1012
ODISHA,2010,37,12,21,2,0,0,35
ODISHA,2010,988,5,23,785,159,5,977
PUDUCHERRY,2010,3,0,3,0,0,0,3
PUDUCHERRY,2010,0,0,0,0,0,0,0
PUDUCHERRY,2010,3,0,3,0,0,0,3
PUNJAB,2010,546,39,83,346,55,1,524
PUNJAB,2010,17,4,7,5,0,0,16
PUNJAB,2010,529,35,76,341,55,1,508
RAJASTHAN,2010,1571,72,277,805,346,36,1536
RAJASTHAN,2010,24,2,6,10,4,0,22
RAJASTHAN,2010,1547,70,271,795,342,36,1514
SIKKIM,2010,18,7,2,1,2,0,12
SIKKIM,2010,2,1,0,0,0,0,1
SIKKIM,2010,16,6,2,1,2,0,11
TAMIL NADU,2010,686,50,139,411,66,0,666
TAMIL NADU,2010,0,0,0,0,0,0,0
TAMIL NADU,2010,686,50,139,411,66,0,666
TRIPURA,2010,238,27,61,93,38,0,219
TRIPURA,2010,0,0,0,0,0,0,0
TRIPURA,2010,238,27,61,93,38,0,219
UTTAR PRADESH,2010,1563,162,246,862,250,0,1520
UTTAR PRADESH,2010,4,1,2,1,0,0,4
UTTAR PRADESH,2010,1559,161,244,861,250,0,1516
UTTARAKHAND,2010,121,3,5,92,19,0,119
UTTARAKHAND,2010,11,2,2,5,1,0,10
UTTARAKHAND,2010,110,1,3,87,18,0,109
WEST BENGAL,2010,2311,22,51,1779,459,0,2311
WEST BENGAL,2010,4,1,0,2,1,0,4
WEST BENGAL,2010,2307,21,51,1777,458,0,2307
ANDAMAN & NICOBAR ISLANDS,2011,3,0,3,0,0,0,3
ANDAMAN & NICOBAR ISLANDS,2011,0,0,0,0,0,0,0
ANDAMAN & NICOBAR ISLANDS,2011,3,0,3,0,0,0,3
ANDHRA PRADESH,2011,1070,110,201,572,128,7,1018
ANDHRA PRADESH,2011,7,0,4,3,0,0,7
ANDHRA PRADESH,2011,1063,110,197,569,128,7,1011
ARUNACHAL PRADESH,2011,48,0,0,42,5,0,47
ARUNACHAL PRADESH,2011,0,0,0,0,0,0,0
ARUNACHAL PRADESH,2011,48,0,0,42,5,0,47
ASSAM,2011,1437,0,40,898,485,14,1437
ASSAM,2011,1,0,1,0,0,0,1
ASSAM,2011,1436,0,39,898,485,14,1436
BIHAR,2011,1555,28,79,1186,253,0,1546
BIHAR,2011,2,2,0,0,0,0,2
BIHAR,2011,1553,26,79,1186,253,0,1544
CHANDIGARH,2011,22,3,2,11,3,0,19
CHANDIGARH,2011,2,1,0,0,0,0,1
CHANDIGARH,2011,20,2,2,11,3,0,18
CHHATTISGARH,2011,982,117,219,500,101,13,950
CHHATTISGARH,2011,63,10,31,14,6,0,61
CHHATTISGARH,2011,919,107,188,486,95,13,889
DADRA & NAGAR HAVELI,2011,7,2,4,0,0,0,6
DADRA & NAGAR HAVELI,2011,0,0,0,0,0,0,0
DADRA & NAGAR HAVELI,2011,7,2,4,0,0,0,6
DAMAN & DIU,2011,1,0,0,1,0,0,1
DAMAN & DIU,2011,0,0,0,0,0,0,0
DAMAN & DIU,2011,1,0,0,1,0,0,1
DELHI,2011,598,94,228,179,24,1,526
DELHI,2011,18,2,9,5,0,0,16
DELHI,2011,580,92,219,174,24,1,510
GOA,2011,20,4,7,4,1,0,16
GOA,2011,1,0,1,0,0,0,1
GOA,2011,19,4,6,4,1,0,15
GUJARAT,2011,316,30,51,180,37,1,299
GUJARAT,2011,3,0,1,0,1,0,2
GUJARAT,2011,313,30,50,180,36,1,297
HARYANA,2011,488,26,79,322,41,3,471
HARYANA,2011,3,2,0,1,0,0,3
HARYANA,2011,485,24,79,321,41,3,468
HIMACHAL PRADESH,2011,159,19,46,58,23,2,148
HIMACHAL PRADESH,2011,2,0,0,0,1,0,1
HIMACHAL PRADESH,2011,157,19,46,58,22,2,147
JAMMU & KASHMIR,2011,288,5,10,176,97,0,288
JAMMU & KASHMIR,2011,0,0,0,0,0,0,0
JAMMU & KASHMIR,2011,288,5,10,176,97,0,288
JHARKHAND,2011,855,15,8,639,188,5,855
JHARKHAND,2011,0,0,0,0,0,0,0
JHARKHAND,2011,855,15,8,639,188,5,855
KARNATAKA,2011,436,32,32,297,48,7,416
KARNATAKA,2011,2,0,1,1,0,0,2
KARNATAKA,2011,434,32,31,296,48,7,414
KERALA,2011,512,45,115,262,63,5,490
KERALA,2011,21,5,4,11,0,0,20
KERALA,2011,491,40,111,251,63,5,470
LAKSHADWEEP,2011,1,0,0,1,0,0,1
LAKSHADWEEP,2011,0,0,0,0,0,0,0
LAKSHADWEEP,2011,1,0,0,1,0,0,1
MADHYA PRADESH,2011,3010,287,692,1399,525,43,2946
MADHYA PRADESH,2011,49,7,23,14,4,0,48
MADHYA PRADESH,2011,2961,280,669,1385,521,43,2898
MAHARASHTRA,2011,1451,125,393,659,168,13,1358
MAHARASHTRA,2011,40,5,9,13,9,0,36
MAHARASHTRA,2011,1411,120,384,646,159,13,1322
MANIPUR,2011,20,2,0,14,2,0,18
MANIPUR,2011,1,0,0,0,0,0,0
MANIPUR,2011,19,2,0,14,2,0,18
MEGHALAYA,2011,82,12,19,36,2,0,69
MEGHALAYA,2011,9,0,1,6,0,0,7
MEGHALAYA,2011,73,12,18,30,2,0,62
MIZORAM,2011,83,23,18,10,7,2,60
MIZORAM,2011,2,0,0,0,0,1,1
MIZORAM,2011,81,23,18,10,7,1,59
NAGALAND,2011,13,0,3,6,4,0,13
NAGALAND,2011,1,0,1,0,0,0,1
NAGALAND,2011,12,0,2,6,4,0,12
ODISHA,2011,939,41,42,659,188,0,930
ODISHA,2011,0,0,0,0,0,0,0
ODISHA,2011,939,41,42,659,188,0,930
PUDUCHERRY,2011,9,0,2,6,0,0,8
PUDUCHERRY,2011,0,0,0,0,0,0,0
PUDUCHERRY,2011,9,0,2,6,0,0,8
PUNJAB,2011,519,38,71,302,79,3,493
PUNJAB,2011,7,0,6,1,0,0,7
PUNJAB,2011,512,38,65,301,79,3,486
RAJASTHAN,2011,1238,79,286,639,187,8,1199
RAJASTHAN,2011,42,7,13,15,3,1,39
RAJASTHAN,2011,1196,72,273,624,184,7,1160
SIKKIM,2011,24,3,5,5,1,0,14
SIKKIM,2011,4,0,1,0,0,0,1
SIKKIM,2011,20,3,4,5,1,0,13
TAMIL NADU,2011,523,41,89,346,35,1,512
TAMIL NADU,2011,2,0,1,0,0,0,1
TAMIL NADU,2011,521,41,88,346,35,1,511
TRIPURA,2011,157,14,16,113,11,0,154
TRIPURA,2011,0,0,0,0,0,0,0
TRIPURA,2011,157,14,16,113,11,0,154
UTTAR PRADESH,2011,1648,109,349,910,267,0,1635
UTTAR PRADESH,2011,1,0,0,0,0,0,0
UTTAR PRADESH,2011,1647,109,349,910,267,0,1635
UTTARAKHAND,2011,117,9,7,74,26,0,116
UTTARAKHAND,2011,8,2,4,2,0,0,8
UTTARAKHAND,2011,109,7,3,72,26,0,108
WEST BENGAL,2011,2106,42,36,1478,531,5,2092
WEST BENGAL,2011,114,2,3,81,25,0,111
WEST BENGAL,2011,1992,40,33,1397,506,5,1981
ANDAMAN & NICOBAR ISLANDS,2012,12,1,7,3,1,0,12
ANDAMAN & NICOBAR ISLANDS,2012,0,0,0,0,0,0,0
ANDAMAN & NICOBAR ISLANDS,2012,12,1,7,3,1,0,12
ANDHRA PRADESH,2012,1257,126,237,660,174,11,1208
ANDHRA PRADESH,2012,13,2,1,5,1,2,11
ANDHRA PRADESH,2012,1244,124,236,655,173,9,1197
ARUNACHAL PRADESH,2012,42,7,0,31,0,0,38
ARUNACHAL PRADESH,2012,0,0,0,0,0,0,0
ARUNACHAL PRADESH,2012,42,7,0,31,0,0,38
ASSAM,2012,1438,5,20,849,541,21,1436
ASSAM,2012,7,0,0,5,2,0,7
ASSAM,2012,1431,5,20,844,539,21,1429
BIHAR,2012,1302,11,80,1028,159,24,1302
BIHAR,2012,3,0,0,1,2,0,3
BIHAR,2012,1299,11,80,1027,157,24,1299
CHANDIGARH,2012,20,3,7,7,1,0,18
CHANDIGARH,2012,3,0,2,1,0,0,3
CHANDIGARH,2012,17,3,5,6,1,0,15
CHHATTISGARH,2012,978,80,307,388,176,3,954
CHHATTISGARH,2012,31,3,15,12,1,0,31
CHHATTISGARH,2012,947,77,292,376,175,3,923
DADRA & NAGAR HAVELI,2012,6,1,2,3,0,0,6
DADRA & NAGAR HAVELI,2012,0,0,0,0,0,0,0
DADRA & NAGAR HAVELI,2012,6,1,2,3,0,0,6
DAMAN & DIU,2012,0,0,0,0,0,0,0
DAMAN & DIU,2012,0,0,0,0,0,0,0
DAMAN & DIU,2012,0,0,0,0,0,0,0
DELHI,2012,466,95,135,133,30,6,399
DELHI,2012,37,12,8,10,1,4,35
DELHI,2012,429,83,127,123,29,2,364
GOA,2012,30,6,11,7,3,2,29
GOA,2012,0,0,0,0,0,0,0
GOA,2012,30,6,11,7,3,2,29
GUJARAT,2012,374,27,57,217,57,1,359
GUJARAT,2012,4,1,2,1,0,0,4
GUJARAT,2012,370,26,55,216,57,1,355
HARYANA,2012,631,22,38,495,61,5,621
HARYANA,2012,8,1,2,4,0,1,8
HARYANA,2012,623,21,36,491,61,4,613
HIMACHAL PRADESH,2012,157,16,44,68,20,1,149
HIMACHAL PRADESH,2012,1,1,0,0,0,0,1
HIMACHAL PRADESH,2012,156,15,44,68,20,1,148
JAMMU & KASHMIR,2012,219,0,3,155,59,0,217
JAMMU & KASHMIR,2012,0,0,0,0,0,0,0
JAMMU & KASHMIR,2012,219,0,3,155,59,0,217
JHARKHAND,2012,791,2,5,662,119,2,790
JHARKHAND,2012,12,0,0,7,5,0,12
JHARKHAND,2012,779,2,5,655,114,2,778
KARNATAKA,2012,446,24,52,301,47,1,425
KARNATAKA,2012,0,0,0,0,0,0,0
KARNATAKA,2012,446,24,52,301,47,1,425
KERALA,2012,568,51,139,274,73,6,543
KERALA,2012,17,6,6,4,1,0,17
KERALA,2012,551,45,133,270,72,6,526
LAKSHADWEEP,2012,2,0,0,1,1,0,2
LAKSHADWEEP,2012,0,0,0,0,0,0,0
LAKSHADWEEP,2012,2,0,0,1,1,0,2
MADHYA PRADESH,2012,2937,227,596,1548,477,20,2868
MADHYA PRADESH,2012,52,9,20,15,5,0,49
MADHYA PRADESH,2012,2885,218,576,1533,472,20,2819
MAHARASHTRA,2012,1558,135,441,707,161,5,1449
MAHARASHTRA,2012,35,5,8,11,6,1,31
MAHARASHTRA,2012,1523,130,433,696,155,4,1418
MANIPUR,2012,38,8,8,12,1,0,29
MANIPUR,2012,0,0,0,0,0,0,0
MANIPUR,2012,38,8,8,12,1,0,29
MEGHALAYA,2012,88,17,14,47,4,0,82
MEGHALAYA,2012,5,3,0,1,0,0,4
MEGHALAYA,2012,83,14,14,46,4,0,78
MIZORAM,2012,77,4,5,49,10,0,68
MIZORAM,2012,3,1,1,1,0,0,3
MIZORAM,2012,74,3,4,48,10,0,65
NAGALAND,2012,19,0,0,19,0,0,19
NAGALAND,2012,1,0,0,1,0,0,1
NAGALAND,2012,18,0,0,18,0,0,18
ODISHA,2012,1113,27,24,645,388,12,1096
ODISHA,2012,17,0,1,13,1,0,15
ODISHA,2012,1096,27,23,632,387,12,1081
PUDUCHERRY,2012,8,1,3,3,1,0,8
PUDUCHERRY,2012,0,0,0,0,0,0,0
PUDUCHERRY,2012,8,1,3,3,1,0,8
PUNJAB,2012,517,36,45,359,47,5,492
PUNJAB,2012,2,0,0,1,1,0,2
PUNJAB,2012,515,36,45,358,46,5,490
RAJASTHAN,2012,1355,116,275,706,219,10,1326
RAJASTHAN,2012,40,6,7,21,4,0,38
RAJASTHAN,2012,1315,110,268,685,215,10,1288
SIKKIM,2012,20,3,1,8,0,0,12
SIKKIM,2012,1,0,0,0,0,0,0
SIKKIM,2012,19,3,1,8,0,0,12
TAMIL NADU,2012,573,29,131,340,46,0,546
TAMIL NADU,2012,1,0,0,0,0,0,0
TAMIL NADU,2012,572,29,131,340,46,0,546
TRIPURA,2012,204,23,65,96,4,0,188
TRIPURA,2012,0,0,0,0,0,0,0
TRIPURA,2012,204,23,65,96,4,0,188
UTTAR PRADESH,2012,1871,171,685,785,186,0,1827
UTTAR PRADESH,2012,1,0,0,0,1,0,1
UTTAR PRADESH,2012,1870,171,685,785,185,0,1826
UTTARAKHAND,2012,87,4,5,64,14,0,87
UTTARAKHAND,2012,6,2,1,2,1,0,6
UTTARAKHAND,2012,81,2,4,62,13,0,81
WEST BENGAL,2012,2263,53,54,1629,504,1,2241
WEST BENGAL,2012,9,2,1,1,0,0,4
WEST BENGAL,2012,2254,51,53,1628,504,1,2237
ANDAMAN & NICOBAR ISLANDS,2013,18,3,7,5,1,0,16
ANDAMAN & NICOBAR ISLANDS,2013,0,0,0,0,0,0,0
ANDAMAN & NICOBAR ISLANDS,2013,18,3,7,5,1,0,16
ANDHRA PRADESH,2013,1188,167,208,642,116,14,1147
ANDHRA PRADESH,2013,2,0,2,0,0,0,2
ANDHRA PRADESH,2013,1186,167,206,642,116,14,1145
ARUNACHAL PRADESH,2013,59,12,0,42,1,0,55
ARUNACHAL PRADESH,2013,0,0,0,0,0,0,0
ARUNACHAL PRADESH,2013,59,12,0,42,1,0,55
ASSAM,2013,1631,6,3,1230,377,14,1630
ASSAM,2013,9,0,0,7,2,0,9
ASSAM,2013,1622,6,3,1223,375,14,1621
BIHAR,2013,929,19,32,765,101,0,917
BIHAR,2013,1,0,0,1,0,0,1
BIHAR,2013,928,19,32,764,101,0,916
CHANDIGARH,2013,29,8,10,8,0,0,26
CHANDIGARH,2013,0,0,0,0,0,0,0
CHANDIGARH,2013,29,8,10,8,0,0,26
CHHATTISGARH,2013,976,227,87,460,113,9,896
CHHATTISGARH,2013,24,2,8,6,5,2,23
CHHATTISGARH,2013,952,225,79,454,108,7,873
DADRA & NAGAR HAVELI,2013,4,2,0,2,0,0,4
DADRA & NAGAR HAVELI,2013,0,0,0,0,0,0,0
DADRA & NAGAR HAVELI,2013,4,2,0,2,0,0,4
DAMAN & DIU,2013,1,0,0,0,0,0,0
DAMAN & DIU,2013,0,0,0,0,0,0,0
DAMAN & DIU,2013,1,0,0,0,0,0,0
DELHI,2013,469,72,188,141,20,1,422
DELHI,2013,19,3,5,6,2,0,16
DELHI,2013,450,69,183,135,18,1,406
GOA,2013,47,11,21,15,2,0,49
GOA,2013,1,0,1,0,0,0,1
GOA,2013,46,11,20,15,2,0,48
GUJARAT,2013,433,27,50,308,32,1,418
GUJARAT,2013,18,2,3,10,2,0,17
GUJARAT,2013,415,25,47,298,30,1,401
HARYANA,2013,603,27,70,430,54,3,584
HARYANA,2013,12,2,0,7,1,0,10
HARYANA,2013,591,25,70,423,53,3,574
HIMACHAL PRADESH,2013,183,16,55,84,16,0,171
HIMACHAL PRADESH,2013,10,2,5,1,1,0,9
HIMACHAL PRADESH,2013,173,14,50,83,15,0,162
JAMMU & KASHMIR,2013,237,1,3,177,52,2,235
JAMMU & KASHMIR,2013,4,1,0,2,1,0,4
JAMMU & KASHMIR,2013,233,0,3,175,51,2,231
JHARKHAND,2013,719,0,5,494,216,0,715
JHARKHAND,2013,22,0,0,16,6,0,22
JHARKHAND,2013,697,0,5,478,210,0,693
KARNATAKA,2013,509,49,18,361,38,4,470
KARNATAKA,2013,18,0,0,17,1,0,18
KARNATAKA,2013,491,49,18,344,37,4,452
KERALA,2013,568,45,157,253,70,10,535
KERALA,2013,18,3,7,4,1,0,15
KERALA,2013,550,42,150,249,69,10,520
LAKSHADWEEP,2013,1,0,0,1,0,0,1
LAKSHADWEEP,2013,0,0,0,0,0,0,0
LAKSHADWEEP,2013,1,0,0,1,0,0,1
MADHYA PRADESH,2013,2998,291,704,1405,511,11,2922
MADHYA PRADESH,2013,14,1,9,2,1,0,13
MADHYA PRADESH,2013,2984,290,695,1403,510,11,2909
MAHARASHTRA,2013,1483,121,363,713,157,8,1362
MAHARASHTRA,2013,76,3,19,47,3,0,72
MAHARASHTRA,2013,1407,118,344,666,154,8,1290
MANIPUR,2013,31,5,2,9,9,1,26
MANIPUR,2013,0,0,0,0,0,0,0
MANIPUR,2013,31,5,2,9,9,1,26
MEGHALAYA,2013,112,23,19,41,7,3,93
MEGHALAYA,2013,5,2,1,1,0,0,4
MEGHALAYA,2013,107,21,18,40,7,3,89
MIZORAM,2013,83,3,3,42,30,0,78
MIZORAM,2013,3,1,0,0,0,0,1
MIZORAM,2013,80,2,3,42,30,0,77
NAGALAND,2013,22,0,0,17,5,0,22
NAGALAND,2013,0,0,0,0,0,0,0
NAGALAND,2013,22,0,0,17,5,0,22
ODISHA,2013,1023,24,57,747,182,7,1017
ODISHA,2013,6,1,0,5,0,0,6
ODISHA,2013,1017,23,57,742,182,7,1011
PUDUCHERRY,2013,1,0,1,0,0,0,1
PUDUCHERRY,2013,0,0,0,0,0,0,0
PUDUCHERRY,2013,1,0,1,0,0,0,1
PUNJAB,2013,511,48,131,258,43,1,481
PUNJAB,2013,8,2,3,3,0,0,8
PUNJAB,2013,503,46,128,255,43,1,473
RAJASTHAN,2013,1519,55,288,856,289,4,1492
RAJASTHAN,2013,36,3,7,20,4,0,34
RAJASTHAN,2013,1483,52,281,836,285,4,1458
SIKKIM,2013,18,5,5,2,2,0,14
SIKKIM,2013,0,0,0,0,0,0,0
SIKKIM,2013,18,5,5,2,2,0,14
TAMIL NADU,2013,596,34,120,390,22,2,568
TAMIL NADU,2013,4,0,3,0,0,0,3
TAMIL NADU,2013,592,34,117,390,22,2,565
TRIPURA,2013,190,22,51,79,28,0,180
TRIPURA,2013,0,0,0,0,0,0,0
TRIPURA,2013,190,22,51,79,28,0,180
UTTAR PRADESH,2013,1759,416,166,911,223,0,1716
UTTAR PRADESH,2013,2,0,1,0,0,0,1
UTTAR PRADESH,2013,1757,416,165,911,223,0,1715
UTTARAKHAND,2013,111,3,3,89,15,0,110
UTTARAKHAND,2013,6,3,1,2,0,0,6
UTTARAKHAND,2013,105,0,2,87,15,0,104
WEST BENGAL,2013,2336,18,85,1835,392,0,2330
WEST BENGAL,2013,3,0,1,1,1,0,3
WEST BENGAL,2013,2333,18,84,1834,391,0,2327
ANDAMAN & NICOBAR ISLANDS,2014,24,1,12,8,1,0,22
ANDAMAN & NICOBAR ISLANDS,2014,0,0,0,0,0,0,0
ANDAMAN & NICOBAR ISLANDS,2014,24,1,12,8,1,0,22
ANDHRA PRADESH,2014,1362,133,283,749,152,15,1332
ANDHRA PRADESH,2014,0,0,0,0,0,0,0
ANDHRA PRADESH,2014,1362,133,283,749,152,15,1332
ARUNACHAL PRADESH,2014,47,10,0,34,1,0,45
ARUNACHAL PRADESH,2014,0,0,0,0,0,0,0
ARUNACHAL PRADESH,2014,47,10,0,34,1,0,45
ASSAM,2014,1721,9,29,1116,556,10,1720
ASSAM,2014,13,0,0,10,3,0,13
ASSAM,2014,1708,9,29,1106,553,10,1707
BIHAR,2014,795,17,89,616,65,0,787
BIHAR,2014,2,1,0,0,0,0,1
BIHAR,2014,793,16,89,616,65,0,786
CHANDIGARH,2014,31,8,4,15,0,0,27
CHANDIGARH,2014,0,0,0,0,0,0,0
CHANDIGARH,2014,31,8,4,15,0,0,27
CHHATTISGARH,2014,1012,87,271,424,190,16,988
CHHATTISGARH,2014,21,2,3,13,3,0,21
CHHATTISGARH,2014,991,85,268,411,187,16,967
DADRA & NAGAR HAVELI,2014,3,1,1,0,0,0,2
DADRA & NAGAR HAVELI,2014,0,0,0,0,0,0,0
DADRA & NAGAR HAVELI,2014,3,1,1,0,0,0,2
DAMAN & DIU,2014,1,0,0,0,0,0,0
DAMAN & DIU,2014,0,0,0,0,0,0,0
DAMAN & DIU,2014,1,0,0,0,0,0,0
DELHI,2014,507,79,174,168,34,1,456
DELHI,2014,21,11,3,1,0,0,15
DELHI,2014,486,68,171,167,34,1,441
GOA,2014,36,5,14,11,0,2,32
GOA,2014,2,0,2,0,0,0,2
GOA,2014,34,5,12,11,0,2,30
GUJARAT,2014,408,28,53,261,42,2,386
GUJARAT,2014,4,0,2,1,0,0,3
GUJARAT,2014,404,28,51,260,42,2,383
HARYANA,2014,720,23,80,481,127,5,716
HARYANA,2014,15,1,1,11,2,0,15
HARYANA,2014,705,22,79,470,125,5,701
HIMACHAL PRADESH,2014,160,16,48,67,20,1,152
HIMACHAL PRADESH,2014,7,3,2,1,0,1,7
HIMACHAL PRADESH,2014,153,13,46,66,20,0,145
JAMMU & KASHMIR,2014,245,1,7,187,50,0,245
JAMMU & KASHMIR,2014,0,0,0,0,0,0,0
JAMMU & KASHMIR,2014,245,1,7,187,50,0,245
JHARKHAND,2014,773,0,0,604,169,0,773
JHARKHAND,2014,11,0,0,10,1,0,11
JHARKHAND,2014,762,0,0,594,168,0,762
KARNATAKA,2014,586,47,69,369,88,3,576
KARNATAKA,2014,2,0,0,2,0,0,2
KARNATAKA,2014,584,47,69,367,88,3,574
KERALA,2014,634,48,133,328,86,12,607
KERALA,2014,14,5,2,2,0,0,9
KERALA,2014,620,43,131,326,86,12,598
LAKSHADWEEP,2014,0,0,0,0,0,0,0
LAKSHADWEEP,2014,0,0,0,0,0,0,0
LAKSHADWEEP,2014,0,0,0,0,0,0,0
MADHYA PRADESH,2014,3135,304,826,1364,577,12,3083
MADHYA PRADESH,2014,21,1,10,4,4,0,19
MADHYA PRADESH,2014,3114,303,816,1360,573,12,3064
MAHARASHTRA,2014,1599,134,515,675,168,11,1503
MAHARASHTRA,2014,44,8,13,18,1,0,40
MAHARASHTRA,2014,1555,126,502,657,167,11,1463
MANIPUR,2014,34,2,8,20,3,0,33
MANIPUR,2014,0,0,0,0,0,0,0
MANIPUR,2014,34,2,8,20,3,0,33
MEGHALAYA,2014,149,34,26,41,17,0,118
MEGHALAYA,2014,8,4,1,1,0,0,6
MEGHALAYA,2014,141,30,25,40,17,0,112
MIZORAM,2014,92,17,15,29,17,4,82
MIZORAM,2014,3,0,1,0,0,0,1
MIZORAM,2014,89,17,14,29,17,4,81
NAGALAND,2014,16,1,2,6,6,0,15
NAGALAND,2014,1,0,1,0,0,0,1
NAGALAND,2014,15,1,1,6,6,0,14
ODISHA,2014,1025,17,44,787,159,5,1012
ODISHA,2014,37,12,21,2,0,0,35
ODISHA,2014,988,5,23,785,159,5,977
PUDUCHERRY,2014,3,0,3,0,0,0,3
PUDUCHERRY,2014,0,0,0,0,0,0,0
PUDUCHERRY,2014,3,0,3,0,0,0,3
PUNJAB,2014,546,39,83,346,55,1,524
PUNJAB,2014,17,4,7,5,0,0,16
PUNJAB,2014,529,35,76,341,55,1,508
RAJASTHAN,2014,1571,72,277,805,346,36,1536
RAJASTHAN,2014,24,2,6,10,4,0,22
RAJASTHAN,2014,1547,70,271,795,342,36,1514
SIKKIM,2014,18,7,2,1,2,0,12
SIKKIM,2014,2,1,0,0,0,0,1
SIKKIM,2014,16,6,2,1,2,0,11
TAMIL NADU,2014,686,50,139,411,66,0,666
TAMIL NADU,2014,0,0,0,0,0,0,0
TAMIL NADU,2014,686,50,139,411,66,0,666
TRIPURA,2014,238,27,61,93,38,0,219
TRIPURA,2014,0,0,0,0,0,0,0
TRIPURA,2014,238,27,61,93,38,0,219
UTTAR PRADESH,2014,1563,162,246,862,250,0,1520
UTTAR PRADESH,2014,4,1,2,1,0,0,4
UTTAR PRADESH,2014,1559,161,244,861,250,0,1516
UTTARAKHAND,2014,121,3,5,92,19,0,119
UTTARAKHAND,2014,11,2,2,5,1,0,10
UTTARAKHAND,2014,110,1,3,87,18,0,109
WEST BENGAL,2014,2311,22,51,1779,459,0,2311
WEST BENGAL,2014,4,1,0,2,1,0,4
WEST BENGAL,2014,2307,21,51,1777,458,0,2307
